//MAP CONVERTED BY dmm2tgm.py THIS HEADER COMMENT PREVENTS RECONVERSION, DO NOT REMOVE
"a" = (
/turf/open/floor/plasteel/tile/monofloor/alt2,
/area/ruin/unpowered)
"A" = (
/turf/open/floor/asphalt,
/area/ruin/unpowered)
"U" = (
/obj/effect/turf_decal/cataclysmdda/asphaltpaint,
/turf/open/floor/asphalt,
/area/ruin/unpowered)

(1,1,1) = {"
a
a
a
A
A
A
A
A
A
A
A
A
A
A
A
a
a
a
"}
(2,1,1) = {"
a
a
a
A
A
A
A
A
A
A
A
A
A
A
A
a
a
a
"}
(3,1,1) = {"
a
a
a
A
A
A
A
A
A
A
A
A
A
A
A
a
a
a
"}
(4,1,1) = {"
A
A
A
A
A
A
A
A
U
U
A
A
A
A
A
A
A
A
"}
(5,1,1) = {"
A
A
A
A
A
A
A
A
U
U
A
A
A
A
A
A
A
A
"}
(6,1,1) = {"
A
A
A
A
A
A
A
A
U
U
A
A
A
A
A
A
A
A
"}
(7,1,1) = {"
A
A
A
A
A
A
A
A
A
A
A
A
A
A
A
A
A
A
"}
(8,1,1) = {"
A
A
A
A
A
A
A
A
A
A
A
A
A
A
A
A
A
A
"}
(9,1,1) = {"
A
A
A
U
U
U
A
A
A
A
A
A
U
U
U
A
A
A
"}
(10,1,1) = {"
A
A
A
U
U
U
A
A
A
A
A
A
U
U
U
A
A
A
"}
(11,1,1) = {"
A
A
A
A
A
A
A
A
A
A
A
A
A
A
A
A
A
A
"}
(12,1,1) = {"
A
A
A
A
A
A
A
A
A
A
A
A
A
A
A
A
A
A
"}
(13,1,1) = {"
A
A
A
A
A
A
A
A
U
U
A
A
A
A
A
A
A
A
"}
(14,1,1) = {"
A
A
A
A
A
A
A
A
U
U
A
A
A
A
A
A
A
A
"}
(15,1,1) = {"
A
A
A
A
A
A
A
A
U
U
A
A
A
A
A
A
A
A
"}
(16,1,1) = {"
a
a
a
A
A
A
A
A
A
A
A
A
A
A
A
a
a
a
"}
(17,1,1) = {"
a
a
a
A
A
A
A
A
A
A
A
A
A
A
A
a
a
a
"}
(18,1,1) = {"
a
a
a
A
A
A
A
A
A
A
A
A
A
A
A
a
a
a
"}
