//MAP CONVERTED BY dmm2tgm.py THIS HEADER COMMENT PREVENTS RECONVERSION, DO NOT REMOVE
"a" = (
/turf/open/floor/plasteel/tile/monofloor/alt2,
/area/ruin/unpowered)
"e" = (
/turf/open/floor/asphalt,
/area/ruin/unpowered)
"i" = (
/obj/effect/abstract/doorway_marker{
	dir = 1
	},
/turf/open/floor/plasteel/tile/monofloor/alt2,
/area/ruin/unpowered)
"H" = (
/obj/effect/turf_decal/cataclysmdda/asphaltpaint,
/obj/effect/abstract/open_area_marker{
	dir = 8
	},
/turf/open/floor/asphalt,
/area/ruin/unpowered)
"P" = (
/obj/effect/turf_decal/cataclysmdda/asphaltpaint,
/turf/open/floor/asphalt,
/area/ruin/unpowered)
"R" = (
/obj/effect/abstract/doorway_marker,
/turf/open/floor/plasteel/tile/monofloor/alt2,
/area/ruin/unpowered)
"W" = (
/obj/effect/abstract/open_area_marker{
	dir = 4
	},
/turf/open/floor/asphalt,
/area/ruin/unpowered)

(1,1,1) = {"
a
a
a
e
e
e
e
e
H
P
e
e
e
e
e
a
a
a
"}
(2,1,1) = {"
a
a
a
e
e
e
e
e
P
P
e
e
e
e
e
a
a
a
"}
(3,1,1) = {"
i
a
a
e
e
e
e
e
P
P
e
e
e
e
e
a
a
R
"}
(4,1,1) = {"
a
a
a
e
e
e
e
e
e
e
e
e
e
e
e
a
a
a
"}
(5,1,1) = {"
a
a
a
e
e
e
e
e
W
e
e
e
e
e
e
a
a
a
"}
