//MAP CONVERTED BY dmm2tgm.py THIS HEADER COMMENT PREVENTS RECONVERSION, DO NOT REMOVE
"a" = (
/turf/open/floor/plasteel/tile/monofloor/alt2,
/area/ruin/unpowered)
"b" = (
/turf/open/floor/asphalt,
/area/ruin/unpowered)
"g" = (
/obj/effect/abstract/open_area_marker{
	dir = 8
	},
/obj/effect/turf_decal/cataclysmdda/asphaltpaint,
/turf/open/floor/asphalt,
/area/ruin/unpowered)
"n" = (
/obj/effect/abstract/open_area_marker{
	dir = 4
	},
/obj/effect/turf_decal/cataclysmdda/asphaltpaint,
/turf/open/floor/asphalt,
/area/ruin/unpowered)
"v" = (
/obj/effect/abstract/open_area_marker{
	dir = 1
	},
/obj/effect/turf_decal/cataclysmdda/asphaltpaint,
/turf/open/floor/asphalt,
/area/ruin/unpowered)
"B" = (
/obj/effect/abstract/open_area_marker,
/obj/effect/turf_decal/cataclysmdda/asphaltpaint,
/turf/open/floor/asphalt,
/area/ruin/unpowered)
"Q" = (
/obj/effect/turf_decal/cataclysmdda/asphaltpaint,
/turf/open/floor/asphalt,
/area/ruin/unpowered)

(1,1,1) = {"
a
b
g
b
a
"}
(2,1,1) = {"
b
b
Q
b
b
"}
(3,1,1) = {"
v
Q
Q
Q
B
"}
(4,1,1) = {"
b
b
Q
b
b
"}
(5,1,1) = {"
a
b
n
b
a
"}
