//MAP CONVERTED BY dmm2tgm.py THIS HEADER COMMENT PREVENTS RECONVERSION, DO NOT REMOVE
"a" = (
/turf/closed/indestructible/black,
/area/partyhard/outdoors)
"h" = (
/turf/open/genturf,
/area/partyhard/outdoors)
"I" = (
/turf/open/floor/plasteel/tile/monofloor/cataclysmdda,
/area/partyhard/indoors)
"U" = (
/turf/closed/wall/cataclysmdda/redbrick,
/area/partyhard/indoors)

(1,1,1) = {"
a
a
a
a
a
a
a
a
a
a
a
a
a
a
a
a
a
a
a
a
a
a
a
a
a
"}
(2,1,1) = {"
a
h
h
h
h
h
h
h
h
h
h
h
h
h
h
h
h
h
h
h
h
h
h
h
a
"}
(3,1,1) = {"
a
h
h
h
h
h
h
h
h
h
h
h
h
h
h
h
h
h
h
h
h
h
h
h
a
"}
(4,1,1) = {"
a
h
h
h
h
h
h
h
h
h
h
h
h
h
U
U
U
U
U
U
U
U
h
h
a
"}
(5,1,1) = {"
a
h
h
h
h
h
h
h
h
h
h
h
h
h
U
I
I
I
I
I
I
U
h
h
a
"}
(6,1,1) = {"
a
h
h
h
h
h
h
h
h
h
h
h
h
h
U
I
I
I
I
I
I
U
h
h
a
"}
(7,1,1) = {"
a
h
h
h
h
h
h
h
h
h
h
h
h
h
I
I
I
I
I
I
I
I
h
h
a
"}
(8,1,1) = {"
a
h
h
h
h
h
h
h
h
h
h
h
h
h
I
I
I
I
I
I
I
I
h
h
a
"}
(9,1,1) = {"
a
h
h
h
h
h
h
h
h
h
h
h
h
h
U
I
I
I
I
I
I
U
h
h
a
"}
(10,1,1) = {"
a
h
h
h
h
h
h
h
h
h
h
h
h
h
U
I
I
I
I
I
I
U
h
h
a
"}
(11,1,1) = {"
a
h
h
h
h
h
h
h
h
h
h
h
h
h
U
U
U
I
I
U
U
U
h
h
a
"}
(12,1,1) = {"
a
h
h
h
h
h
h
h
h
h
h
h
h
h
h
h
h
h
h
h
h
h
h
h
a
"}
(13,1,1) = {"
a
h
h
h
h
h
h
h
h
h
h
h
h
h
h
h
h
h
h
h
h
h
h
h
a
"}
(14,1,1) = {"
a
h
h
h
h
h
h
h
h
h
h
h
h
h
h
h
h
h
h
h
h
h
h
h
a
"}
(15,1,1) = {"
a
h
h
h
h
h
h
h
h
h
h
h
h
h
h
h
h
h
h
h
h
h
h
h
a
"}
(16,1,1) = {"
a
h
h
h
h
h
h
h
h
h
h
h
h
h
h
h
h
h
h
h
h
h
h
h
a
"}
(17,1,1) = {"
a
h
h
h
h
h
h
h
h
h
h
h
h
h
h
h
h
h
h
h
h
h
h
h
a
"}
(18,1,1) = {"
a
h
h
h
h
h
h
h
h
h
h
h
h
h
h
h
h
h
h
h
h
h
h
h
a
"}
(19,1,1) = {"
a
h
h
h
h
h
h
h
h
h
h
h
h
h
h
h
h
h
h
h
h
h
h
h
a
"}
(20,1,1) = {"
a
h
h
h
h
h
h
h
h
h
h
h
h
h
h
h
h
h
h
h
h
h
h
h
a
"}
(21,1,1) = {"
a
h
h
h
h
h
h
h
h
h
h
h
h
h
h
h
h
h
h
h
h
h
h
h
a
"}
(22,1,1) = {"
a
h
h
h
h
h
h
h
h
h
h
h
h
h
h
h
h
h
h
h
h
h
h
h
a
"}
(23,1,1) = {"
a
h
h
h
h
h
h
h
h
h
h
h
h
h
h
h
h
h
h
h
h
h
h
h
a
"}
(24,1,1) = {"
a
h
h
h
h
h
h
h
h
h
h
h
h
h
h
h
h
h
h
h
h
h
h
h
a
"}
(25,1,1) = {"
a
a
a
a
a
a
a
a
a
a
a
a
a
a
a
a
a
a
a
a
a
a
a
a
a
"}
