//MAP CONVERTED BY dmm2tgm.py THIS HEADER COMMENT PREVENTS RECONVERSION, DO NOT REMOVE
"a" = (
/turf/closed/wall/r_wall,
/area/ruin/unpowered)
"b" = (
/obj/effect/abstract/doorway_marker{
	dir = 1
	},
/turf/open/floor/plasteel/catwalk_floor,
/area/ruin/unpowered)
"l" = (
/obj/effect/turf_decal/stripes/line{
	dir = 4
	},
/obj/structure/rack,
/obj/item/gun/ballistic/rifle/boltaction/kar98k/empty,
/obj/structure/window/reinforced{
	dir = 4
	},
/obj/structure/window/reinforced,
/obj/structure/window/reinforced{
	dir = 1
	},
/turf/open/floor/engine,
/area/ruin/unpowered)
"q" = (
/obj/effect/abstract/doorway_marker,
/turf/open/floor/plasteel/catwalk_floor,
/area/ruin/unpowered)
"t" = (
/obj/effect/turf_decal/stripes/line{
	dir = 4
	},
/obj/structure/rack,
/obj/item/gun/ballistic/rifle/boltaction/kar98k,
/obj/structure/window/reinforced{
	dir = 4
	},
/obj/structure/window/reinforced{
	dir = 1
	},
/turf/open/floor/engine,
/area/ruin/unpowered)
"v" = (
/obj/effect/turf_decal/stripes/line{
	dir = 4
	},
/obj/structure/rack,
/obj/item/gun/ballistic/rifle/boltaction/kar98k/empty,
/obj/structure/window/reinforced{
	dir = 4
	},
/obj/structure/window/reinforced,
/turf/open/floor/engine,
/area/ruin/unpowered)
"C" = (
/obj/effect/turf_decal/stripes/line{
	dir = 4
	},
/obj/structure/rack,
/obj/item/gun/ballistic/rifle/boltaction/kar98k/scope,
/obj/structure/window/reinforced{
	dir = 4
	},
/obj/structure/window/reinforced,
/obj/structure/window/reinforced{
	dir = 1
	},
/turf/open/floor/engine,
/area/ruin/unpowered)
"H" = (
/obj/effect/turf_decal/stripes/line{
	dir = 8
	},
/obj/structure/rack,
/obj/item/clothing/suit/armor/ussr,
/obj/item/clothing/head/helmet/ussr,
/obj/machinery/light{
	dir = 4
	},
/obj/structure/window/reinforced{
	dir = 8
	},
/obj/structure/window/reinforced{
	dir = 1
	},
/turf/open/floor/engine,
/area/ruin/unpowered)
"I" = (
/obj/effect/turf_decal/stripes/line{
	dir = 8
	},
/obj/structure/rack,
/obj/item/clothing/suit/armor/ussr,
/obj/item/clothing/head/helmet/ussr,
/obj/structure/window/reinforced{
	dir = 8
	},
/obj/structure/window/reinforced{
	dir = 1
	},
/obj/structure/window/reinforced,
/turf/open/floor/engine,
/area/ruin/unpowered)
"N" = (
/turf/open/floor/plasteel/catwalk_floor,
/area/ruin/unpowered)
"T" = (
/obj/effect/turf_decal/stripes/line{
	dir = 8
	},
/obj/structure/rack,
/obj/item/clothing/suit/armor/ussr,
/obj/item/clothing/head/helmet/ussr,
/obj/machinery/light{
	dir = 4
	},
/obj/structure/window/reinforced{
	dir = 8
	},
/obj/structure/window/reinforced,
/turf/open/floor/engine,
/area/ruin/unpowered)

(1,1,1) = {"
a
a
a
a
a
a
"}
(2,1,1) = {"
a
v
l
C
t
a
"}
(3,1,1) = {"
b
N
N
N
N
q
"}
(4,1,1) = {"
a
T
I
I
H
a
"}
(5,1,1) = {"
a
a
a
a
a
a
"}
