//MAP CONVERTED BY dmm2tgm.py THIS HEADER COMMENT PREVENTS RECONVERSION, DO NOT REMOVE
"d" = (
/obj/effect/abstract/open_area_marker,
/turf/open/floor/plasteel,
/area/ruin/unpowered)
"h" = (
/turf/closed/wall/r_wall,
/area/ruin/unpowered)
"s" = (
/obj/effect/turf_decal/bot_white/right,
/obj/effect/turf_decal/tile/neutral{
	dir = 1
	},
/obj/effect/turf_decal/tile/neutral,
/obj/effect/turf_decal/tile/neutral{
	dir = 4
	},
/obj/effect/turf_decal/tile/neutral{
	dir = 8
	},
/turf/open/floor/plasteel/dark,
/area/ruin/unpowered)
"x" = (
/obj/effect/turf_decal/tile/neutral{
	dir = 1
	},
/obj/effect/turf_decal/tile/neutral,
/obj/effect/turf_decal/tile/neutral{
	dir = 4
	},
/obj/effect/turf_decal/tile/neutral{
	dir = 8
	},
/turf/open/floor/plasteel/dark,
/area/ruin/unpowered)
"C" = (
/obj/machinery/door/poddoor/shutters{
	id = "gateshutter";
	name = "Gateway Access Shutter"
	},
/obj/effect/turf_decal/delivery,
/obj/machinery/door/firedoor/border_only,
/obj/machinery/door/firedoor/border_only{
	dir = 1
	},
/turf/open/floor/plasteel,
/area/ruin/unpowered)
"H" = (
/obj/machinery/status_display/evac{
	pixel_y = 32
	},
/obj/effect/turf_decal/bot_white,
/obj/effect/turf_decal/tile/neutral{
	dir = 1
	},
/obj/effect/turf_decal/tile/neutral,
/obj/effect/turf_decal/tile/neutral{
	dir = 4
	},
/obj/effect/turf_decal/tile/neutral{
	dir = 8
	},
/turf/open/floor/plasteel/dark,
/area/ruin/unpowered)
"K" = (
/obj/effect/turf_decal/bot_white,
/obj/effect/turf_decal/tile/neutral{
	dir = 1
	},
/obj/effect/turf_decal/tile/neutral,
/obj/effect/turf_decal/tile/neutral{
	dir = 4
	},
/obj/effect/turf_decal/tile/neutral{
	dir = 8
	},
/turf/open/floor/plasteel/dark,
/area/ruin/unpowered)
"M" = (
/obj/effect/turf_decal/stripes/line,
/turf/open/floor/plasteel,
/area/ruin/unpowered)
"S" = (
/obj/machinery/gateway,
/turf/open/floor/plasteel/dark,
/area/ruin/unpowered)
"T" = (
/obj/effect/turf_decal/bot_white/left,
/obj/effect/turf_decal/tile/neutral{
	dir = 1
	},
/obj/effect/turf_decal/tile/neutral,
/obj/effect/turf_decal/tile/neutral{
	dir = 4
	},
/obj/effect/turf_decal/tile/neutral{
	dir = 8
	},
/turf/open/floor/plasteel/dark,
/area/ruin/unpowered)
"V" = (
/turf/open/floor/plasteel,
/area/ruin/unpowered)

(1,1,1) = {"
h
h
h
h
h
h
h
h
h
"}
(2,1,1) = {"
h
s
K
T
x
M
C
V
V
"}
(3,1,1) = {"
h
H
S
K
x
M
C
V
d
"}
(4,1,1) = {"
h
T
K
s
x
M
C
V
V
"}
(5,1,1) = {"
h
h
h
h
h
h
h
h
h
"}
