//MAP CONVERTED BY dmm2tgm.py THIS HEADER COMMENT PREVENTS RECONVERSION, DO NOT REMOVE
"a" = (
/turf/closed/wall,
/area/ruin/unpowered)
"d" = (
/obj/effect/turf_decal/stripes/line{
	dir = 5
	},
/turf/open/floor/plasteel/elevatorshaft,
/area/ruin/unpowered)
"e" = (
/obj/effect/turf_decal/stripes/line{
	dir = 8
	},
/turf/open/floor/plasteel/elevatorshaft,
/area/ruin/unpowered)
"g" = (
/obj/effect/abstract/doorway_marker{
	dir = 8
	},
/turf/open/floor/plasteel,
/area/ruin/unpowered)
"l" = (
/obj/effect/abstract/doorway_marker{
	dir = 4
	},
/turf/open/floor/plasteel,
/area/ruin/unpowered)
"n" = (
/obj/effect/turf_decal/stripes/line{
	dir = 4
	},
/obj/item/kirbyplants/random,
/turf/open/floor/plasteel/elevatorshaft,
/area/ruin/unpowered)
"o" = (
/obj/effect/turf_decal/stripes/line{
	dir = 8
	},
/obj/item/kirbyplants/random,
/turf/open/floor/plasteel/elevatorshaft,
/area/ruin/unpowered)
"q" = (
/turf/open/floor/plasteel/catwalk_floor,
/area/ruin/unpowered)
"r" = (
/obj/effect/abstract/doorway_marker,
/turf/open/floor/plasteel,
/area/ruin/unpowered)
"s" = (
/obj/machinery/light/floor,
/obj/effect/turf_decal/stripes/box,
/turf/open/floor/plasteel/elevatorshaft,
/area/ruin/unpowered)
"A" = (
/obj/effect/abstract/doorway_marker{
	dir = 1
	},
/turf/open/floor/plasteel,
/area/ruin/unpowered)
"B" = (
/obj/effect/turf_decal/stripes/line,
/turf/open/floor/plasteel/elevatorshaft,
/area/ruin/unpowered)
"G" = (
/obj/effect/turf_decal/stripes/line{
	dir = 1
	},
/turf/open/floor/plasteel/elevatorshaft,
/area/ruin/unpowered)
"O" = (
/obj/effect/turf_decal/stripes/line{
	dir = 6
	},
/turf/open/floor/plasteel/elevatorshaft,
/area/ruin/unpowered)
"P" = (
/obj/effect/turf_decal/stripes/line{
	dir = 10
	},
/turf/open/floor/plasteel/elevatorshaft,
/area/ruin/unpowered)
"Q" = (
/obj/effect/turf_decal/stripes/line{
	dir = 1
	},
/obj/item/kirbyplants/random,
/turf/open/floor/plasteel/elevatorshaft,
/area/ruin/unpowered)
"T" = (
/obj/effect/turf_decal/stripes/line,
/obj/item/kirbyplants/random,
/turf/open/floor/plasteel/elevatorshaft,
/area/ruin/unpowered)
"W" = (
/obj/effect/turf_decal/stripes/line{
	dir = 9
	},
/turf/open/floor/plasteel/elevatorshaft,
/area/ruin/unpowered)
"X" = (
/obj/effect/turf_decal/stripes/line{
	dir = 4
	},
/turf/open/floor/plasteel/elevatorshaft,
/area/ruin/unpowered)

(1,1,1) = {"
a
a
g
a
a
a
a
"}
(2,1,1) = {"
a
B
q
d
n
X
a
"}
(3,1,1) = {"
a
T
q
q
q
q
r
"}
(4,1,1) = {"
a
O
q
s
q
W
a
"}
(5,1,1) = {"
A
q
q
q
q
Q
a
"}
(6,1,1) = {"
a
e
o
P
q
G
a
"}
(7,1,1) = {"
a
a
a
a
l
a
a
"}
