//MAP CONVERTED BY dmm2tgm.py THIS HEADER COMMENT PREVENTS RECONVERSION, DO NOT REMOVE
"a" = (
/turf/template_noop,
/area/template_noop)
"d" = (
/obj/effect/decal/cleanable/dirt,
/turf/open/floor/plating/airless,
/area/ruin/space/abandoned_tele)
"e" = (
/obj/structure/closet,
/obj/item/gps/spaceruin,
/turf/open/floor/plating/airless,
/area/ruin/space/abandoned_tele)
"g" = (
/obj/effect/decal/cleanable/oil,
/turf/open/floor/plating/airless,
/area/ruin/space/abandoned_tele)
"i" = (
/obj/item/shard,
/obj/item/electronics/apc,
/turf/open/floor/plating/airless,
/area/ruin/space/abandoned_tele)
"l" = (
/turf/open/floor/plating/airless,
/area/ruin/space/abandoned_tele)
"m" = (
/obj/machinery/portable_atmospherics/canister/air,
/turf/open/floor/plating/airless,
/area/ruin/space/abandoned_tele)
"n" = (
/obj/effect/abstract/doorway_marker{
	dir = 8
	},
/turf/open/floor/plating/airless,
/area/ruin/space/abandoned_tele)
"p" = (
/obj/effect/decal/cleanable/robot_debris/old,
/turf/open/floor/plating/airless,
/area/ruin/space/abandoned_tele)
"s" = (
/obj/structure/frame/computer,
/turf/open/floor/plating/airless,
/area/ruin/space/abandoned_tele)
"y" = (
/turf/closed/wall/r_wall,
/area/ruin/space/abandoned_tele)
"z" = (
/obj/structure/lattice,
/turf/template_noop,
/area/template_noop)
"A" = (
/obj/machinery/teleport/hub,
/turf/open/floor/plating/airless,
/area/ruin/space/abandoned_tele)
"C" = (
/obj/structure/closet/crate,
/obj/item/aicard,
/obj/item/multitool,
/obj/item/weldingtool,
/obj/item/wrench,
/obj/item/circuitboard/computer/teleporter,
/turf/open/floor/plating/airless,
/area/ruin/space/abandoned_tele)
"D" = (
/obj/item/stock_parts/cell,
/turf/open/floor/plating/airless,
/area/ruin/space/abandoned_tele)
"I" = (
/obj/effect/decal/cleanable/dirt,
/obj/item/flashlight,
/turf/open/floor/plating/airless,
/area/ruin/space/abandoned_tele)
"J" = (
/obj/effect/decal/cleanable/dirt,
/obj/item/beacon,
/turf/open/floor/plating/airless,
/area/ruin/space/abandoned_tele)
"K" = (
/obj/effect/decal/cleanable/blood/old,
/turf/open/floor/plating/airless,
/area/ruin/space/abandoned_tele)
"L" = (
/obj/item/storage/toolbox/electrical{
	pixel_x = 1;
	pixel_y = -1
	},
/turf/open/floor/plating/airless,
/area/ruin/space/abandoned_tele)
"N" = (
/obj/item/shard{
	icon_state = "medium"
	},
/turf/open/floor/plating/airless,
/area/ruin/space/abandoned_tele)
"P" = (
/obj/effect/abstract/doorway_marker{
	dir = 4
	},
/turf/open/floor/plating/airless,
/area/ruin/space/abandoned_tele)
"Q" = (
/obj/effect/abstract/doorway_marker,
/turf/open/floor/plating/airless,
/area/ruin/space/abandoned_tele)
"S" = (
/obj/machinery/teleport/station,
/turf/open/floor/plating/airless,
/area/ruin/space/abandoned_tele)
"V" = (
/obj/structure/reagent_dispensers/fueltank,
/turf/open/floor/plating/airless,
/area/ruin/space/abandoned_tele)
"W" = (
/obj/structure/rack,
/obj/item/clothing/gloves/color/yellow,
/turf/open/floor/plating/airless,
/area/ruin/space/abandoned_tele)
"Z" = (
/obj/effect/spawner/lootdrop/crate_spawner,
/turf/open/floor/plating/airless,
/area/ruin/space/abandoned_tele)

(1,1,1) = {"
a
z
y
y
n
y
y
z
a
"}
(2,1,1) = {"
a
y
y
l
l
m
y
y
a
"}
(3,1,1) = {"
y
y
N
D
I
K
l
y
y
"}
(4,1,1) = {"
y
s
l
d
p
l
l
C
y
"}
(5,1,1) = {"
y
S
l
l
J
g
d
l
Q
"}
(6,1,1) = {"
y
A
l
p
l
l
l
V
y
"}
(7,1,1) = {"
y
y
W
d
l
i
L
y
y
"}
(8,1,1) = {"
z
y
y
Z
m
e
y
y
z
"}
(9,1,1) = {"
a
a
y
y
P
y
y
a
a
"}
