//MAP CONVERTED BY dmm2tgm.py THIS HEADER COMMENT PREVENTS RECONVERSION, DO NOT REMOVE
"a" = (
/obj/effect/turf_decal/stripes/line{
	dir = 4
	},
/obj/effect/decal/cleanable/cobweb,
/obj/effect/turf_decal/tile/red{
	dir = 8
	},
/obj/effect/turf_decal/tile/red{
	dir = 4
	},
/obj/effect/turf_decal/tile/red{
	dir = 1
	},
/turf/open/floor/plasteel,
/area/template_noop)
"b" = (
/obj/structure/window/reinforced{
	dir = 8
	},
/turf/open/floor/plasteel/dark,
/area/template_noop)
"c" = (
/obj/effect/turf_decal/stripes/line{
	dir = 8
	},
/obj/effect/decal/cleanable/dirt,
/obj/effect/turf_decal/tile/red{
	dir = 4
	},
/obj/effect/turf_decal/tile/red,
/obj/effect/turf_decal/tile/red{
	dir = 1
	},
/turf/open/floor/plasteel,
/area/template_noop)
"d" = (
/obj/structure/window/reinforced{
	dir = 4
	},
/turf/open/floor/plasteel/dark,
/area/template_noop)
"e" = (
/obj/structure/window/reinforced{
	dir = 8
	},
/obj/structure/window/reinforced,
/turf/open/floor/plasteel/dark,
/area/template_noop)
"f" = (
/obj/effect/turf_decal/bot,
/obj/effect/decal/cleanable/dirt,
/obj/machinery/atmospherics/components/unary/outlet_injector/on{
	dir = 8
	},
/turf/open/floor/plasteel/dark,
/area/template_noop)
"g" = (
/obj/effect/turf_decal/stripes/line{
	dir = 8
	},
/turf/open/floor/plasteel,
/area/template_noop)
"h" = (
/obj/structure/window/reinforced{
	dir = 8
	},
/obj/machinery/atmospherics/pipe/smart/simple/general/visible{
	dir = 6
	},
/turf/open/floor/plasteel/dark,
/area/template_noop)
"i" = (
/obj/structure/window/reinforced{
	dir = 4
	},
/obj/effect/decal/cleanable/dirt,
/obj/machinery/atmospherics/pipe/smart/simple/general/visible{
	dir = 10
	},
/turf/open/floor/plasteel/dark,
/area/template_noop)
"j" = (
/obj/effect/turf_decal/stripes/line{
	dir = 4
	},
/turf/open/floor/plasteel,
/area/template_noop)
"k" = (
/obj/effect/turf_decal/bot,
/obj/machinery/atmospherics/components/unary/outlet_injector/on{
	dir = 4
	},
/turf/open/floor/plasteel/dark,
/area/template_noop)
"l" = (
/obj/effect/turf_decal/stripes/line{
	dir = 8
	},
/obj/effect/decal/cleanable/dirt,
/turf/open/floor/plasteel,
/area/template_noop)
"m" = (
/obj/structure/window/reinforced{
	dir = 8
	},
/obj/machinery/atmospherics/pipe/smart/simple/general/visible,
/turf/open/floor/plasteel/dark,
/area/template_noop)
"n" = (
/obj/structure/chair,
/obj/effect/decal/cleanable/dirt,
/turf/open/floor/plasteel/dark,
/area/template_noop)
"o" = (
/obj/structure/window/reinforced{
	dir = 4
	},
/obj/effect/decal/cleanable/dirt,
/turf/open/floor/plasteel/dark,
/area/template_noop)
"q" = (
/obj/structure/window/reinforced,
/obj/structure/window/reinforced{
	dir = 4
	},
/obj/machinery/atmospherics/pipe/smart/simple/general/visible,
/turf/open/floor/plasteel/dark,
/area/template_noop)
"r" = (
/obj/effect/turf_decal/stripes/line{
	dir = 4
	},
/obj/effect/decal/cleanable/dirt,
/turf/open/floor/plasteel,
/area/template_noop)
"s" = (
/obj/machinery/atmospherics/components/binary/pump{
	dir = 1
	},
/obj/effect/turf_decal/stripes/line{
	dir = 1
	},
/turf/open/floor/plasteel,
/area/template_noop)
"t" = (
/obj/effect/turf_decal/stripes/line{
	dir = 1
	},
/obj/effect/turf_decal/caution,
/turf/open/floor/plasteel,
/area/template_noop)
"u" = (
/obj/effect/turf_decal/stripes/line{
	dir = 1
	},
/turf/open/floor/plasteel,
/area/template_noop)
"v" = (
/obj/effect/turf_decal/stripes/corner{
	dir = 1
	},
/turf/open/floor/plasteel,
/area/template_noop)
"w" = (
/obj/structure/window/reinforced{
	dir = 8
	},
/obj/effect/decal/cleanable/dirt,
/turf/open/floor/plasteel/dark,
/area/template_noop)
"x" = (
/obj/effect/turf_decal/stripes/line{
	dir = 4
	},
/obj/effect/turf_decal/tile/red{
	dir = 8
	},
/obj/effect/turf_decal/tile/red{
	dir = 1
	},
/turf/open/floor/plasteel,
/area/template_noop)
"y" = (
/obj/effect/turf_decal/box,
/obj/machinery/atmospherics/components/unary/portables_connector/visible{
	dir = 8
	},
/turf/open/floor/plasteel,
/area/template_noop)
"z" = (
/obj/structure/window/reinforced{
	dir = 4
	},
/obj/effect/decal/cleanable/dirt,
/obj/machinery/atmospherics/pipe/smart/simple/general/visible,
/turf/open/floor/plasteel/dark,
/area/template_noop)
"A" = (
/obj/effect/turf_decal/stripes/line{
	dir = 8
	},
/obj/effect/decal/cleanable/dirt,
/obj/effect/turf_decal/tile/red{
	dir = 4
	},
/obj/effect/turf_decal/tile/red,
/turf/open/floor/plasteel,
/area/template_noop)
"C" = (
/obj/machinery/door/window/southleft,
/obj/effect/decal/cleanable/dirt,
/turf/open/floor/plasteel/dark,
/area/template_noop)
"D" = (
/obj/structure/window/reinforced,
/obj/structure/window/reinforced{
	dir = 4
	},
/obj/effect/decal/remains/human,
/turf/open/floor/plasteel/dark,
/area/template_noop)
"E" = (
/obj/effect/turf_decal/stripes/corner{
	dir = 4
	},
/obj/effect/decal/cleanable/dirt,
/turf/open/floor/plasteel,
/area/template_noop)
"F" = (
/obj/effect/turf_decal/stripes/line{
	dir = 1
	},
/obj/effect/decal/cleanable/dirt,
/turf/open/floor/plasteel,
/area/template_noop)
"G" = (
/obj/effect/turf_decal/stripes/line{
	dir = 1
	},
/obj/effect/turf_decal/caution,
/obj/effect/decal/cleanable/dirt,
/turf/open/floor/plasteel,
/area/template_noop)
"H" = (
/obj/effect/decal/cleanable/dirt,
/turf/open/floor/plasteel,
/area/template_noop)
"I" = (
/obj/effect/turf_decal/stripes/corner{
	dir = 4
	},
/obj/effect/decal/cleanable/dirt,
/obj/effect/turf_decal/tile/red{
	dir = 8
	},
/obj/effect/turf_decal/tile/red{
	dir = 1
	},
/turf/open/floor/plasteel,
/area/template_noop)
"J" = (
/obj/effect/turf_decal/box,
/obj/effect/decal/cleanable/dirt,
/obj/machinery/atmospherics/components/unary/portables_connector/visible{
	dir = 4
	},
/turf/open/floor/plasteel,
/area/template_noop)
"K" = (
/obj/effect/turf_decal/stripes/corner{
	dir = 1
	},
/obj/effect/turf_decal/tile/red{
	dir = 4
	},
/obj/effect/turf_decal/tile/red,
/turf/open/floor/plasteel,
/area/template_noop)
"L" = (
/obj/effect/decal/cleanable/dirt,
/obj/effect/turf_decal/tile/red{
	dir = 8
	},
/obj/effect/turf_decal/tile/red{
	dir = 1
	},
/obj/effect/turf_decal/tile/red,
/turf/open/floor/plasteel,
/area/template_noop)
"M" = (
/obj/effect/decal/cleanable/dirt,
/obj/effect/turf_decal/tile/red{
	dir = 8
	},
/obj/effect/turf_decal/tile/red,
/obj/machinery/atmospherics/pipe/smart/simple/general/visible{
	dir = 5
	},
/turf/open/floor/plasteel,
/area/template_noop)
"N" = (
/obj/machinery/light,
/obj/effect/turf_decal/tile/red{
	dir = 8
	},
/obj/effect/turf_decal/tile/red,
/obj/machinery/atmospherics/pipe/smart/simple/general/visible{
	dir = 4
	},
/turf/open/floor/plasteel,
/area/template_noop)
"O" = (
/obj/effect/turf_decal/tile/red{
	dir = 8
	},
/obj/effect/turf_decal/tile/red,
/obj/machinery/atmospherics/pipe/smart/simple/general/visible{
	dir = 9
	},
/turf/open/floor/plasteel,
/area/template_noop)
"P" = (
/obj/effect/turf_decal/tile/red{
	dir = 8
	},
/obj/effect/turf_decal/tile/red{
	dir = 4
	},
/obj/effect/turf_decal/tile/red,
/turf/open/floor/plasteel,
/area/template_noop)
"Q" = (
/obj/effect/turf_decal/stripes/line{
	dir = 8
	},
/obj/effect/landmark/blobstart,
/turf/open/floor/plasteel,
/area/template_noop)
"R" = (
/obj/structure/window/reinforced{
	dir = 8
	},
/obj/structure/window/reinforced,
/obj/effect/decal/cleanable/dirt,
/obj/machinery/atmospherics/pipe/smart/simple/general/visible,
/turf/open/floor/plasteel/dark,
/area/template_noop)
"S" = (
/obj/machinery/door/window/southleft,
/turf/open/floor/plasteel/dark,
/area/template_noop)

(1,1,1) = {"
a
x
r
I
L
"}
(2,1,1) = {"
h
m
R
s
M
"}
(3,1,1) = {"
f
n
C
t
N
"}
(4,1,1) = {"
d
o
D
u
y
"}
(5,1,1) = {"
g
l
Q
v
H
"}
(6,1,1) = {"
j
r
r
E
H
"}
(7,1,1) = {"
b
w
e
F
J
"}
(8,1,1) = {"
k
n
S
G
N
"}
(9,1,1) = {"
i
z
q
s
O
"}
(10,1,1) = {"
c
A
g
K
P
"}
