//MAP CONVERTED BY dmm2tgm.py THIS HEADER COMMENT PREVENTS RECONVERSION, DO NOT REMOVE
"a" = (
/obj/machinery/vending/cigarette,
/turf/open/floor/plating,
/area/template_noop)
"b" = (
/obj/machinery/door/airlock/maintenance/external/glass,
/turf/open/floor/plasteel,
/area/template_noop)
"c" = (
/turf/open/floor/plasteel,
/area/template_noop)
"d" = (
/obj/effect/decal/cleanable/dirt/dust,
/turf/open/floor/plating,
/area/template_noop)
"f" = (
/obj/effect/turf_decal/tile/blue,
/obj/effect/turf_decal/tile/blue{
	dir = 8
	},
/obj/effect/spawner/lootdrop/maintenance/three,
/obj/structure/closet/crate,
/turf/open/floor/plasteel,
/area/template_noop)
"g" = (
/obj/effect/landmark/blobstart,
/turf/open/floor/plating,
/area/template_noop)
"h" = (
/obj/effect/turf_decal/tile/blue,
/obj/effect/turf_decal/tile/blue{
	dir = 4
	},
/obj/effect/decal/cleanable/dirt/dust,
/turf/open/floor/plasteel,
/area/template_noop)
"i" = (
/turf/open/floor/plating{
	icon_state = "panelscorched"
	},
/area/template_noop)
"k" = (
/obj/effect/turf_decal/tile/blue,
/obj/effect/turf_decal/tile/blue{
	dir = 4
	},
/obj/machinery/light/small{
	dir = 8
	},
/obj/effect/decal/cleanable/dirt/dust,
/turf/open/floor/plasteel,
/area/template_noop)
"n" = (
/obj/effect/decal/cleanable/dirt/dust,
/turf/open/floor/plasteel,
/area/template_noop)
"o" = (
/turf/open/floor/plating{
	icon_state = "platingdmg3"
	},
/area/template_noop)
"p" = (
/turf/closed/wall,
/area/template_noop)
"q" = (
/obj/structure/chair/comfy/teal,
/turf/open/floor/plating,
/area/template_noop)
"s" = (
/obj/effect/landmark/event_spawn,
/obj/effect/decal/cleanable/dirt/dust,
/turf/open/floor/plasteel,
/area/template_noop)
"t" = (
/obj/effect/turf_decal/tile/blue{
	dir = 1
	},
/obj/effect/turf_decal/tile/blue{
	dir = 8
	},
/obj/effect/turf_decal/tile/blue{
	dir = 4
	},
/obj/effect/decal/cleanable/dirt/dust,
/turf/open/floor/plasteel,
/area/template_noop)
"v" = (
/obj/item/storage/pod{
	pixel_x = 32
	},
/turf/open/floor/plating,
/area/template_noop)
"x" = (
/obj/effect/turf_decal/tile/blue,
/obj/effect/turf_decal/tile/blue{
	dir = 8
	},
/obj/structure/closet/crate,
/obj/effect/spawner/lootdrop/maintenance/three,
/obj/machinery/light/broken,
/turf/open/floor/plasteel,
/area/template_noop)
"z" = (
/obj/effect/turf_decal/tile/blue{
	dir = 4
	},
/obj/effect/turf_decal/tile/blue{
	dir = 1
	},
/obj/structure/sign/nanotrasen{
	pixel_y = 32
	},
/obj/structure/chair/comfy/teal,
/turf/open/floor/plasteel,
/area/template_noop)
"A" = (
/obj/machinery/light{
	dir = 1
	},
/obj/effect/decal/cleanable/dirt/dust,
/turf/open/floor/plasteel,
/area/template_noop)
"B" = (
/obj/effect/turf_decal/tile/blue,
/obj/effect/turf_decal/tile/blue{
	dir = 8
	},
/obj/effect/turf_decal/tile/blue{
	dir = 4
	},
/turf/open/floor/plasteel,
/area/template_noop)
"F" = (
/obj/effect/decal/cleanable/dirt/dust,
/turf/open/floor/plating{
	icon_state = "panelscorched"
	},
/area/template_noop)
"G" = (
/turf/open/floor/plating{
	icon_state = "platingdmg2"
	},
/area/template_noop)
"H" = (
/obj/effect/turf_decal/tile/blue{
	dir = 4
	},
/obj/effect/turf_decal/tile/blue{
	dir = 1
	},
/obj/structure/chair/comfy/teal,
/obj/item/radio/intercom{
	pixel_y = 26
	},
/obj/effect/decal/cleanable/dirt/dust,
/turf/open/floor/plasteel,
/area/template_noop)
"I" = (
/obj/effect/turf_decal/tile/blue{
	dir = 8
	},
/obj/effect/turf_decal/tile/blue{
	dir = 1
	},
/obj/effect/decal/cleanable/dirt/dust,
/turf/open/floor/plasteel,
/area/template_noop)
"J" = (
/obj/structure/table,
/obj/item/folder/white,
/obj/item/wrench/medical,
/turf/open/floor/plating,
/area/template_noop)
"K" = (
/obj/effect/turf_decal/tile/blue{
	dir = 4
	},
/obj/effect/turf_decal/tile/blue{
	dir = 1
	},
/obj/structure/chair/comfy/teal,
/obj/effect/decal/cleanable/dirt/dust,
/obj/machinery/light/broken{
	dir = 1
	},
/turf/open/floor/plasteel,
/area/template_noop)
"M" = (
/obj/effect/turf_decal/tile/blue,
/obj/effect/turf_decal/tile/blue{
	dir = 8
	},
/turf/open/floor/plasteel,
/area/template_noop)
"O" = (
/obj/machinery/newscaster{
	pixel_x = 32
	},
/turf/open/floor/plating,
/area/template_noop)
"P" = (
/obj/effect/turf_decal/tile/blue,
/obj/effect/turf_decal/tile/blue{
	dir = 8
	},
/obj/effect/decal/cleanable/dirt/dust,
/turf/open/floor/plasteel,
/area/template_noop)
"S" = (
/turf/open/floor/plating,
/area/template_noop)
"V" = (
/obj/effect/decal/cleanable/dirt/dust,
/obj/machinery/light/small/broken{
	dir = 4;
	icon_state = "bulb-broken"
	},
/turf/open/floor/plating,
/area/template_noop)
"X" = (
/obj/structure/rack,
/obj/effect/spawner/lootdrop/maintenance/five,
/turf/open/floor/plating,
/area/template_noop)

(1,1,1) = {"
t
I
S
J
a
"}
(2,1,1) = {"
H
S
o
c
f
"}
(3,1,1) = {"
K
F
s
G
x
"}
(4,1,1) = {"
z
n
g
S
M
"}
(5,1,1) = {"
q
i
G
c
P
"}
(6,1,1) = {"
S
c
S
c
d
"}
(7,1,1) = {"
F
n
S
c
X
"}
(8,1,1) = {"
A
V
n
v
X
"}
(9,1,1) = {"
p
p
b
p
p
"}
(10,1,1) = {"
S
O
h
k
B
"}
