//MAP CONVERTED BY dmm2tgm.py THIS HEADER COMMENT PREVENTS RECONVERSION, DO NOT REMOVE
"ab" = (
/turf/template_noop,
/area/template_noop)
"gf" = (
/obj/structure/closet/crate/solarpanel_small,
/turf/open/floor/plating,
/area/maintenance/bottom_station_maints)
"jH" = (
/obj/structure/lattice,
/obj/structure/grille,
/turf/open/space/basic,
/area/space/nearstation)
"lr" = (
/obj/effect/spawner/structure/window/reinforced,
/turf/open/floor/plating,
/area/maintenance/bottom_station_maints/north)
"lH" = (
/obj/machinery/door/firedoor/border_only{
	dir = 4
	},
/obj/machinery/door/firedoor/border_only{
	dir = 8
	},
/obj/machinery/door/airlock/external{
	name = "External Access";
	req_access_txt = "13"
	},
/obj/structure/fans/tiny,
/turf/open/floor/plating,
/area/cargo/meeting_room)
"oH" = (
/obj/structure/closet/emcloset/anchored,
/turf/open/floor/plating,
/area/maintenance/bottom_station_maints)
"xZ" = (
/obj/machinery/door/airlock/external{
	name = "External Access";
	req_access_txt = "13"
	},
/obj/structure/fans/tiny,
/turf/open/floor/plating,
/area/maintenance/bottom_station_maints)
"BR" = (
/turf/open/floor/plating,
/area/maintenance/bottom_station_maints)
"DF" = (
/turf/closed/wall/r_wall,
/area/maintenance/bottom_station_maints)
"Pc" = (
/turf/closed/wall/r_wall,
/area/cargo/meeting_room)
"UY" = (
/turf/open/floor/plating,
/area/cargo/meeting_room)
"Ws" = (
/turf/closed/wall/r_wall,
/area/maintenance/bottom_station_maints/north)
"YS" = (
/turf/open/space/basic,
/area/space)
"Zl" = (
/obj/structure/lattice,
/turf/open/space/basic,
/area/space/nearstation)

(1,1,1) = {"
ab
ab
ab
ab
ab
ab
ab
YS
YS
YS
jH
YS
YS
YS
YS
Zl
YS
YS
YS
YS
YS
YS
Zl
YS
YS
YS
YS
Pc
UY
Pc
Zl
YS
YS
ab
ab
ab
"}
(2,1,1) = {"
ab
ab
ab
ab
ab
ab
ab
YS
YS
YS
jH
YS
YS
YS
YS
Zl
YS
YS
YS
YS
YS
YS
Zl
YS
YS
YS
YS
Pc
lH
Pc
Zl
YS
YS
ab
ab
ab
"}
(3,1,1) = {"
ab
ab
ab
ab
ab
ab
ab
YS
YS
YS
jH
YS
YS
YS
YS
Zl
Zl
Zl
Zl
Zl
Zl
Zl
Zl
Zl
Zl
Zl
Zl
Zl
Zl
Zl
Zl
Zl
Zl
ab
ab
ab
"}
(4,1,1) = {"
ab
ab
ab
ab
ab
ab
ab
YS
YS
YS
YS
YS
YS
YS
YS
jH
YS
YS
YS
YS
YS
YS
Zl
YS
YS
YS
YS
YS
Zl
YS
Zl
YS
YS
ab
ab
ab
"}
(5,1,1) = {"
ab
ab
ab
ab
ab
ab
ab
YS
YS
YS
YS
YS
YS
YS
YS
jH
YS
YS
YS
YS
YS
YS
Zl
YS
YS
YS
YS
YS
Zl
YS
Zl
YS
YS
ab
ab
ab
"}
(6,1,1) = {"
ab
ab
ab
ab
ab
ab
ab
YS
YS
YS
YS
YS
YS
YS
YS
jH
YS
YS
YS
YS
YS
YS
Zl
YS
YS
YS
YS
YS
Zl
YS
Zl
YS
YS
ab
ab
ab
"}
(7,1,1) = {"
ab
ab
ab
ab
ab
ab
ab
YS
YS
YS
YS
YS
YS
YS
YS
jH
YS
YS
YS
YS
YS
YS
Zl
YS
YS
YS
YS
YS
Zl
YS
Zl
YS
YS
ab
ab
ab
"}
(8,1,1) = {"
ab
ab
ab
ab
ab
ab
ab
Zl
jH
Zl
Zl
Zl
Zl
Zl
Zl
jH
YS
YS
YS
YS
YS
YS
Zl
YS
YS
YS
YS
YS
Zl
Zl
Zl
Zl
Zl
ab
ab
ab
"}
(9,1,1) = {"
ab
ab
ab
ab
ab
ab
ab
YS
YS
YS
YS
YS
YS
YS
YS
jH
YS
YS
YS
YS
YS
YS
Zl
YS
YS
YS
YS
YS
Zl
YS
Zl
YS
YS
ab
ab
ab
"}
(10,1,1) = {"
ab
ab
ab
ab
ab
ab
ab
YS
YS
YS
YS
YS
YS
YS
YS
jH
YS
YS
YS
YS
YS
YS
Zl
YS
YS
YS
YS
YS
YS
YS
Zl
YS
YS
ab
ab
ab
"}
(11,1,1) = {"
ab
ab
ab
ab
ab
ab
ab
YS
YS
YS
YS
YS
YS
YS
YS
jH
YS
YS
YS
Zl
jH
jH
jH
jH
jH
jH
jH
jH
jH
jH
Zl
YS
YS
ab
ab
ab
"}
(12,1,1) = {"
ab
ab
ab
ab
ab
ab
ab
YS
YS
YS
YS
YS
YS
YS
YS
jH
YS
YS
YS
YS
YS
YS
Zl
YS
YS
YS
YS
YS
YS
YS
Zl
YS
YS
ab
ab
ab
"}
(13,1,1) = {"
ab
ab
ab
ab
ab
ab
ab
YS
YS
YS
Zl
YS
YS
YS
YS
jH
YS
YS
YS
YS
YS
YS
Zl
YS
YS
YS
YS
YS
YS
YS
Zl
YS
YS
ab
ab
ab
"}
(14,1,1) = {"
ab
ab
ab
ab
ab
ab
ab
YS
YS
YS
Zl
YS
YS
YS
YS
jH
YS
YS
YS
YS
YS
YS
Zl
YS
YS
YS
YS
YS
YS
YS
Zl
Zl
Zl
ab
ab
ab
"}
(15,1,1) = {"
ab
ab
ab
ab
ab
ab
Ws
Zl
Zl
Zl
Zl
Zl
Zl
Zl
Zl
Zl
Zl
Zl
Zl
Zl
Zl
Zl
Zl
Zl
Zl
Zl
Zl
Zl
Zl
Zl
Zl
YS
YS
YS
YS
ab
"}
(16,1,1) = {"
ab
ab
ab
ab
ab
ab
Ws
YS
YS
YS
Zl
YS
YS
YS
YS
Zl
YS
YS
YS
YS
YS
YS
Zl
YS
YS
YS
YS
YS
YS
YS
Zl
YS
YS
YS
YS
ab
"}
(17,1,1) = {"
ab
ab
ab
ab
ab
ab
Ws
YS
YS
YS
Zl
YS
YS
YS
YS
Zl
YS
YS
YS
YS
YS
YS
Zl
YS
YS
YS
YS
YS
YS
YS
Zl
YS
YS
YS
YS
ab
"}
(18,1,1) = {"
ab
ab
ab
ab
ab
ab
Ws
YS
YS
YS
Zl
YS
YS
Zl
Zl
Zl
Zl
Zl
Zl
Zl
Zl
Zl
Zl
Zl
Zl
YS
YS
YS
YS
YS
Zl
YS
YS
YS
YS
ab
"}
(19,1,1) = {"
ab
ab
ab
ab
ab
ab
Ws
YS
YS
YS
Zl
YS
YS
YS
YS
Zl
YS
YS
YS
YS
YS
YS
Zl
YS
YS
YS
YS
YS
YS
YS
Zl
YS
YS
YS
YS
ab
"}
(20,1,1) = {"
ab
ab
ab
ab
ab
ab
Ws
YS
YS
YS
Zl
YS
YS
YS
YS
Zl
YS
YS
YS
YS
YS
YS
Zl
YS
YS
YS
YS
YS
YS
YS
Zl
YS
YS
YS
YS
ab
"}
(21,1,1) = {"
ab
ab
ab
ab
ab
ab
Ws
YS
YS
YS
Zl
YS
YS
YS
YS
Zl
YS
YS
YS
YS
YS
YS
Zl
YS
YS
YS
YS
YS
YS
Zl
Zl
Zl
Zl
Zl
Zl
ab
"}
(22,1,1) = {"
ab
ab
ab
ab
ab
ab
Ws
YS
YS
YS
Zl
YS
YS
YS
YS
Zl
YS
YS
YS
YS
YS
YS
Zl
YS
YS
YS
YS
YS
YS
YS
Zl
YS
YS
YS
YS
ab
"}
(23,1,1) = {"
ab
ab
ab
ab
ab
ab
Ws
YS
YS
YS
Zl
YS
YS
YS
YS
Zl
YS
YS
YS
YS
YS
YS
Zl
YS
YS
YS
YS
YS
YS
YS
Zl
YS
YS
YS
YS
ab
"}
(24,1,1) = {"
ab
ab
ab
ab
ab
ab
Ws
YS
YS
YS
Zl
YS
YS
YS
YS
Zl
YS
YS
YS
YS
YS
YS
Zl
YS
YS
YS
YS
YS
YS
YS
Zl
YS
YS
YS
YS
ab
"}
(25,1,1) = {"
ab
ab
ab
ab
ab
ab
Ws
Zl
Zl
Zl
Zl
Zl
Zl
Zl
Zl
Zl
Zl
Zl
Zl
Zl
Zl
Zl
Zl
Zl
Zl
Zl
Zl
Zl
Zl
Zl
Zl
Zl
Zl
Zl
Zl
ab
"}
(26,1,1) = {"
ab
ab
ab
ab
ab
ab
Ws
Zl
YS
YS
Zl
YS
YS
YS
YS
Zl
YS
YS
YS
YS
YS
YS
Zl
YS
YS
YS
YS
YS
YS
YS
Zl
YS
YS
DF
xZ
ab
"}
(27,1,1) = {"
ab
ab
ab
ab
ab
ab
Ws
Zl
YS
YS
Zl
YS
YS
YS
YS
Zl
YS
YS
YS
YS
YS
YS
Zl
YS
YS
YS
YS
YS
YS
YS
Zl
YS
DF
DF
BR
ab
"}
(28,1,1) = {"
ab
ab
ab
ab
ab
ab
Ws
Zl
YS
YS
Zl
YS
YS
YS
YS
Zl
YS
YS
YS
YS
YS
YS
Zl
YS
YS
YS
YS
YS
YS
YS
Zl
YS
DF
gf
BR
ab
"}
(29,1,1) = {"
ab
ab
ab
ab
ab
ab
Ws
Zl
YS
YS
YS
YS
YS
YS
YS
Zl
YS
YS
YS
YS
YS
YS
Zl
YS
YS
YS
YS
YS
YS
YS
Zl
YS
DF
oH
BR
ab
"}
(30,1,1) = {"
ab
ab
ab
ab
ab
ab
Ws
Zl
YS
YS
YS
YS
YS
YS
YS
Zl
YS
YS
YS
YS
YS
YS
Zl
YS
YS
YS
YS
ab
ab
ab
ab
ab
ab
ab
ab
ab
"}
(31,1,1) = {"
ab
ab
ab
ab
ab
ab
Ws
Zl
YS
YS
YS
YS
YS
YS
YS
Zl
YS
YS
YS
YS
YS
YS
Zl
YS
YS
YS
YS
ab
ab
ab
ab
ab
ab
ab
ab
ab
"}
(32,1,1) = {"
ab
ab
ab
ab
ab
ab
Ws
jH
jH
jH
jH
jH
jH
jH
Zl
Zl
Zl
Zl
Zl
Zl
Zl
Zl
Zl
Zl
Zl
Zl
Zl
ab
ab
ab
ab
ab
ab
ab
ab
ab
"}
(33,1,1) = {"
ab
ab
ab
ab
ab
ab
Ws
lr
lr
lr
lr
lr
lr
lr
Ws
Zl
YS
YS
YS
YS
YS
YS
Zl
YS
YS
YS
YS
ab
ab
ab
ab
ab
ab
ab
ab
ab
"}
(34,1,1) = {"
ab
ab
ab
ab
ab
ab
ab
ab
ab
ab
ab
ab
ab
ab
Ws
Zl
YS
YS
YS
YS
YS
YS
Zl
YS
YS
YS
YS
ab
ab
ab
ab
ab
ab
ab
ab
ab
"}
(35,1,1) = {"
ab
ab
ab
ab
ab
ab
ab
ab
ab
ab
ab
ab
ab
ab
Ws
Zl
YS
YS
YS
YS
YS
YS
Zl
YS
YS
YS
YS
ab
ab
ab
ab
ab
ab
ab
ab
ab
"}
(36,1,1) = {"
ab
ab
ab
ab
ab
ab
ab
ab
ab
ab
ab
ab
ab
ab
Ws
Zl
YS
YS
YS
YS
YS
YS
Zl
YS
YS
YS
YS
ab
ab
ab
ab
ab
ab
ab
ab
ab
"}
(37,1,1) = {"
ab
ab
ab
ab
ab
ab
ab
ab
ab
ab
ab
ab
ab
ab
Ws
Ws
Ws
Ws
Ws
Ws
Ws
Ws
Ws
lr
Ws
Ws
Ws
ab
ab
ab
ab
ab
ab
ab
ab
ab
"}
