//MAP CONVERTED BY dmm2tgm.py THIS HEADER COMMENT PREVENTS RECONVERSION, DO NOT REMOVE
"ab" = (
/turf/template_noop,
/area/template_noop)
"cA" = (
/turf/closed/wall/r_wall,
/area/engineering/main)
"tB" = (
/obj/structure/lattice,
/turf/template_noop,
/area/space/nearstation)
"uZ" = (
/obj/structure/sign/warning/vacuum,
/turf/closed/wall/r_wall,
/area/engineering/main)
"xY" = (
/obj/machinery/door/firedoor,
/obj/structure/fans/tiny,
/obj/effect/mapping_helpers/airlock/abandoned,
/obj/structure/barricade/wooden{
	name = "wooden barricade (CLOSED)"
	},
/obj/structure/cable,
/obj/machinery/door/airlock/external{
	req_access_txt = "12"
	},
/turf/open/floor/plating,
/area/engineering/main)
"FH" = (
/obj/effect/spawner/structure/window/reinforced,
/turf/open/floor/plating,
/area/engineering/main)
"UB" = (
/obj/structure/lattice/catwalk,
/obj/structure/cable,
/turf/template_noop,
/area/space/nearstation)

(1,1,1) = {"
ab
ab
ab
ab
ab
ab
tB
ab
ab
ab
ab
ab
tB
ab
ab
ab
ab
ab
ab
ab
tB
ab
ab
ab
ab
ab
"}
(2,1,1) = {"
ab
ab
ab
ab
ab
ab
tB
ab
ab
ab
ab
ab
tB
ab
ab
ab
ab
ab
ab
ab
tB
ab
ab
ab
ab
ab
"}
(3,1,1) = {"
ab
ab
ab
ab
ab
ab
tB
ab
ab
ab
ab
ab
tB
ab
ab
ab
ab
ab
ab
ab
tB
ab
ab
ab
ab
ab
"}
(4,1,1) = {"
ab
ab
ab
ab
ab
ab
tB
ab
ab
ab
ab
ab
tB
ab
ab
ab
ab
ab
ab
ab
tB
ab
ab
ab
ab
ab
"}
(5,1,1) = {"
tB
tB
tB
tB
tB
tB
tB
tB
tB
tB
tB
tB
tB
tB
tB
tB
tB
tB
tB
tB
tB
tB
ab
ab
ab
ab
"}
(6,1,1) = {"
ab
ab
ab
ab
ab
ab
tB
ab
ab
ab
ab
ab
tB
ab
ab
ab
ab
ab
ab
ab
tB
ab
ab
ab
ab
ab
"}
(7,1,1) = {"
ab
ab
ab
ab
ab
ab
tB
ab
ab
ab
ab
ab
tB
ab
ab
ab
ab
ab
ab
ab
tB
ab
ab
ab
ab
ab
"}
(8,1,1) = {"
ab
ab
ab
ab
ab
ab
tB
ab
ab
ab
ab
ab
tB
ab
ab
ab
ab
ab
ab
ab
tB
ab
ab
ab
ab
ab
"}
(9,1,1) = {"
ab
ab
ab
ab
ab
ab
tB
ab
ab
ab
ab
ab
tB
ab
ab
ab
ab
ab
ab
ab
tB
ab
ab
ab
ab
ab
"}
(10,1,1) = {"
ab
ab
ab
ab
ab
ab
tB
ab
ab
ab
ab
ab
tB
ab
ab
ab
ab
ab
ab
ab
tB
ab
ab
ab
ab
ab
"}
(11,1,1) = {"
tB
tB
tB
tB
tB
tB
tB
tB
tB
tB
tB
tB
tB
tB
tB
tB
tB
tB
tB
tB
tB
tB
ab
ab
ab
ab
"}
(12,1,1) = {"
ab
ab
ab
ab
ab
ab
tB
ab
ab
tB
ab
ab
tB
ab
ab
ab
ab
tB
ab
ab
tB
ab
ab
ab
ab
ab
"}
(13,1,1) = {"
ab
ab
ab
ab
ab
ab
tB
ab
ab
tB
ab
ab
tB
ab
ab
ab
ab
tB
ab
ab
tB
ab
ab
ab
ab
ab
"}
(14,1,1) = {"
ab
ab
ab
ab
ab
ab
tB
ab
ab
tB
ab
ab
tB
ab
ab
ab
ab
tB
ab
ab
tB
ab
ab
ab
ab
ab
"}
(15,1,1) = {"
cA
tB
tB
tB
tB
tB
tB
tB
tB
tB
tB
tB
tB
tB
tB
tB
tB
tB
tB
tB
tB
ab
ab
ab
ab
ab
"}
(16,1,1) = {"
cA
ab
ab
ab
ab
ab
tB
ab
ab
tB
ab
ab
ab
ab
tB
ab
ab
tB
ab
ab
tB
tB
ab
ab
ab
ab
"}
(17,1,1) = {"
cA
ab
ab
ab
ab
ab
tB
ab
ab
tB
ab
ab
ab
ab
tB
ab
ab
tB
ab
ab
tB
ab
ab
ab
ab
ab
"}
(18,1,1) = {"
cA
ab
ab
ab
ab
ab
tB
ab
ab
tB
ab
ab
ab
ab
tB
ab
ab
tB
ab
ab
tB
ab
ab
ab
ab
ab
"}
(19,1,1) = {"
uZ
ab
ab
ab
ab
ab
tB
ab
ab
tB
ab
ab
ab
ab
tB
ab
ab
tB
ab
ab
tB
tB
ab
ab
ab
ab
"}
(20,1,1) = {"
xY
UB
ab
ab
ab
ab
tB
ab
ab
tB
tB
tB
tB
tB
tB
ab
ab
tB
ab
ab
tB
ab
ab
ab
ab
ab
"}
(21,1,1) = {"
cA
ab
ab
ab
ab
ab
tB
ab
ab
tB
ab
ab
tB
ab
tB
ab
ab
tB
ab
ab
tB
ab
ab
ab
ab
ab
"}
(22,1,1) = {"
cA
ab
ab
ab
ab
ab
tB
ab
ab
tB
ab
ab
tB
tB
tB
tB
tB
tB
ab
ab
tB
ab
ab
ab
ab
ab
"}
(23,1,1) = {"
cA
ab
ab
ab
ab
ab
tB
ab
ab
tB
ab
ab
tB
ab
ab
ab
ab
tB
ab
ab
tB
tB
ab
ab
ab
ab
"}
(24,1,1) = {"
cA
ab
ab
ab
ab
ab
tB
ab
ab
tB
ab
ab
tB
ab
ab
ab
ab
tB
ab
ab
tB
ab
ab
ab
ab
ab
"}
(25,1,1) = {"
cA
tB
tB
tB
tB
tB
tB
tB
tB
tB
tB
tB
tB
tB
tB
tB
tB
tB
tB
tB
tB
ab
ab
ab
ab
ab
"}
(26,1,1) = {"
cA
ab
ab
ab
ab
ab
tB
ab
ab
tB
ab
ab
tB
ab
ab
ab
ab
tB
ab
ab
tB
tB
ab
ab
ab
ab
"}
(27,1,1) = {"
cA
ab
ab
ab
ab
ab
tB
ab
ab
tB
ab
ab
tB
ab
ab
ab
ab
tB
ab
ab
tB
ab
ab
ab
ab
ab
"}
(28,1,1) = {"
cA
ab
ab
ab
ab
ab
tB
ab
ab
tB
ab
ab
tB
ab
ab
ab
ab
tB
ab
ab
tB
ab
ab
ab
ab
ab
"}
(29,1,1) = {"
cA
ab
ab
ab
ab
ab
tB
ab
ab
tB
ab
ab
tB
ab
ab
ab
ab
tB
ab
ab
tB
ab
ab
ab
ab
ab
"}
(30,1,1) = {"
FH
ab
ab
ab
ab
ab
tB
ab
ab
tB
ab
ab
tB
ab
ab
ab
ab
tB
ab
ab
tB
ab
ab
ab
ab
ab
"}
(31,1,1) = {"
cA
tB
tB
tB
tB
tB
tB
tB
tB
tB
tB
tB
tB
tB
tB
tB
tB
tB
tB
tB
tB
tB
ab
ab
ab
ab
"}
(32,1,1) = {"
cA
ab
ab
ab
ab
ab
tB
ab
ab
ab
ab
ab
tB
ab
ab
ab
ab
ab
ab
ab
tB
ab
ab
ab
ab
ab
"}
