//MAP CONVERTED BY dmm2tgm.py THIS HEADER COMMENT PREVENTS RECONVERSION, DO NOT REMOVE
"bt" = (
/obj/effect/turf_decal/trimline/blue/filled/line{
	dir = 9
	},
/obj/machinery/vending/wardrobe/chem_wardrobe,
/turf/open/floor/plasteel/white,
/area/medical/chemistry)
"cd" = (
/obj/machinery/firealarm/directional/east,
/obj/structure/chair/sofa{
	dir = 8
	},
/obj/machinery/camera{
	c_tag = "Psychology";
	dir = 8;
	network = list("ss13","medbay");
	pixel_y = -22
	},
/turf/open/floor/carpet/blue,
/area/medical/psychology)
"ee" = (
/obj/structure/filingcabinet,
/turf/open/floor/plasteel/monofloor/white,
/area/medical/psychology)
"em" = (
/obj/effect/turf_decal/trimline/blue/filled/line,
/obj/item/radio/intercom{
	pixel_y = -35
	},
/turf/open/floor/plasteel/white,
/area/medical/medbay/zone2)
"fa" = (
/obj/machinery/atmospherics/components/unary/vent_pump/on/layer4,
/turf/open/floor/plasteel/monofloor/white,
/area/medical/psychology)
"fc" = (
/obj/structure/cable,
/obj/machinery/atmospherics/pipe/smart/manifold4w/scrubbers/hidden/layer2{
	dir = 8
	},
/obj/machinery/atmospherics/pipe/smart/manifold4w/supply/hidden/layer4,
/turf/open/floor/plating,
/area/medical/psychology)
"fE" = (
/obj/effect/turf_decal/trimline/blue/filled/line,
/obj/structure/cable,
/obj/structure/extinguisher_cabinet{
	pixel_y = -30
	},
/obj/machinery/atmospherics/components/unary/vent_scrubber/on/layer2{
	dir = 4
	},
/turf/open/floor/plasteel/white,
/area/medical/chemistry)
"ge" = (
/obj/effect/turf_decal/trimline/blue/filled/line{
	dir = 8
	},
/turf/open/floor/plasteel/white,
/area/medical/chemistry)
"gL" = (
/obj/machinery/atmospherics/pipe/smart/manifold4w/supply/hidden/layer4,
/turf/open/floor/carpet/blue,
/area/medical/psychology)
"hj" = (
/obj/effect/turf_decal/trimline/blue/filled/line{
	dir = 4
	},
/obj/structure/table,
/obj/item/stack/ducts/fifty,
/obj/item/stack/ducts/fifty,
/obj/item/stack/ducts/fifty,
/obj/item/stack/ducts/fifty,
/obj/item/stack/ducts/fifty,
/obj/item/plunger,
/turf/open/floor/plasteel/white,
/area/medical/chemistry)
"hG" = (
/obj/effect/turf_decal/trimline/blue/filled/line{
	dir = 4
	},
/obj/machinery/atmospherics/pipe/smart/manifold4w/supply/hidden/layer4,
/obj/machinery/atmospherics/pipe/smart/manifold4w/scrubbers/hidden/layer2{
	dir = 8
	},
/obj/structure/cable,
/turf/open/floor/plasteel/monofloor/white,
/area/medical/medbay/zone2)
"ir" = (
/turf/open/floor/plasteel/monofloor/white,
/area/medical/chemistry)
"iW" = (
/obj/effect/turf_decal/trimline/blue/filled/line{
	dir = 5
	},
/obj/machinery/light{
	dir = 4
	},
/obj/machinery/atmospherics/pipe/smart/manifold4w/scrubbers/hidden/layer2{
	dir = 8
	},
/obj/machinery/atmospherics/pipe/smart/manifold4w/supply/hidden/layer4,
/obj/structure/sign/departments/chemistry{
	pixel_y = 32
	},
/turf/open/floor/plasteel/white,
/area/medical/medbay/zone2)
"jI" = (
/obj/effect/turf_decal/trimline/blue/filled/line{
	dir = 8
	},
/obj/machinery/firealarm{
	dir = 4;
	pixel_x = -24
	},
/obj/structure/stairs/north,
/turf/open/floor/plasteel/white,
/area/medical/medbay/zone2)
"jN" = (
/obj/machinery/door/airlock/maintenance{
	dir = 4;
	name = "Medbay Maintenance";
	req_access_txt = "5"
	},
/obj/effect/mapping_helpers/airlock/locked,
/turf/open/floor/plating,
/area/medical/chemistry)
"lX" = (
/obj/machinery/atmospherics/pipe/smart/manifold4w/general/visible,
/obj/effect/turf_decal/trimline/blue/filled/line{
	dir = 8
	},
/obj/machinery/light{
	dir = 8
	},
/obj/machinery/requests_console{
	department = "Medbay";
	departmentType = 1;
	name = "Medbay RC";
	pixel_x = -30
	},
/obj/structure/railing,
/turf/open/floor/plasteel/white,
/area/medical/medbay/zone2)
"ob" = (
/obj/machinery/atmospherics/pipe/smart/manifold4w/general/visible,
/obj/structure/railing,
/turf/open/floor/plasteel/monofloor/white,
/area/medical/medbay/zone2)
"oe" = (
/obj/machinery/atmospherics/components/unary/cryo_cell,
/obj/effect/turf_decal/trimline/blue/filled/line{
	dir = 1
	},
/turf/open/floor/plasteel/white,
/area/medical/medbay/zone2)
"oH" = (
/obj/machinery/atmospherics/pipe/smart/manifold4w/general/visible,
/turf/open/floor/plasteel/monofloor/white,
/area/medical/medbay/zone2)
"pt" = (
/obj/machinery/atmospherics/components/unary/vent_scrubber/on/layer2{
	dir = 4
	},
/turf/open/floor/plasteel/monofloor/white,
/area/medical/medbay/zone2)
"pR" = (
/obj/structure/table/wood,
/obj/machinery/computer/med_data/laptop{
	dir = 4
	},
/turf/open/floor/plasteel/monofloor/white,
/area/medical/psychology)
"qp" = (
/obj/effect/turf_decal/trimline/blue/filled/line{
	dir = 1
	},
/obj/machinery/atmospherics/pipe/smart/manifold4w/scrubbers/hidden/layer2{
	dir = 8
	},
/obj/machinery/atmospherics/pipe/smart/manifold4w/supply/hidden/layer4,
/obj/structure/cable,
/turf/open/floor/plasteel/white,
/area/medical/medbay/zone2)
"qT" = (
/obj/structure/closet/secure_closet/psychology,
/turf/open/floor/plasteel/monofloor/white,
/area/medical/psychology)
"ru" = (
/obj/effect/turf_decal/trimline/blue/filled/line{
	dir = 1
	},
/obj/structure/table/glass,
/obj/item/storage/box/beakers{
	pixel_x = 2;
	pixel_y = 2
	},
/obj/item/reagent_containers/glass/beaker/large,
/obj/item/reagent_containers/dropper,
/obj/machinery/airalarm{
	pixel_y = 23
	},
/turf/open/floor/plasteel/white,
/area/medical/chemistry)
"sl" = (
/obj/machinery/firealarm{
	dir = 1;
	pixel_y = -24
	},
/obj/effect/turf_decal/trimline/blue/filled/line,
/obj/machinery/atmospherics/pipe/smart/manifold4w/scrubbers/hidden/layer2{
	dir = 8
	},
/obj/machinery/atmospherics/pipe/smart/manifold4w/supply/hidden/layer4,
/obj/structure/cable,
/turf/open/floor/plasteel/white,
/area/medical/chemistry)
"su" = (
/obj/machinery/atmospherics/pipe/smart/manifold4w/general/visible,
/obj/structure/railing/corner{
	dir = 8
	},
/turf/open/floor/plasteel/monofloor/white,
/area/medical/medbay/zone2)
"tG" = (
/turf/closed/wall/r_wall,
/area/medical/psychology)
"tI" = (
/turf/template_noop,
/area/template_noop)
"uk" = (
/obj/machinery/atmospherics/pipe/smart/manifold4w/scrubbers/hidden/layer2{
	dir = 8
	},
/turf/open/floor/plasteel/monofloor/white,
/area/medical/medbay/zone2)
"uR" = (
/obj/effect/turf_decal/trimline/blue/filled/line,
/obj/machinery/atmospherics/pipe/smart/manifold4w/supply/hidden/layer4,
/obj/machinery/airalarm{
	dir = 1;
	pixel_y = -23
	},
/obj/machinery/light,
/turf/open/floor/plasteel/white,
/area/medical/medbay/zone2)
"vQ" = (
/obj/effect/turf_decal/trimline/blue/filled/line{
	dir = 5
	},
/obj/structure/table,
/obj/item/storage/toolbox/mechanical{
	pixel_y = 11
	},
/obj/item/clothing/head/welding,
/obj/item/construction/plumbing{
	pixel_y = -10
	},
/turf/open/floor/plasteel/white,
/area/medical/chemistry)
"vY" = (
/obj/effect/turf_decal/trimline/blue/filled/line{
	dir = 5
	},
/obj/machinery/light/small{
	dir = 1;
	pixel_y = 0
	},
/obj/machinery/airalarm{
	dir = 8;
	pixel_x = 23
	},
/turf/open/floor/plasteel/white,
/area/medical/chemistry)
"xl" = (
/obj/structure/cable,
/turf/open/floor/plasteel/monofloor/white,
/area/medical/chemistry)
"xH" = (
/obj/effect/turf_decal/trimline/blue/filled/line,
/obj/machinery/atmospherics/pipe/smart/manifold4w/scrubbers/hidden/layer2{
	dir = 8
	},
/obj/machinery/atmospherics/pipe/smart/manifold4w/supply/hidden/layer4,
/obj/structure/cable,
/turf/open/floor/plasteel/white,
/area/medical/medbay/zone2)
"xJ" = (
/obj/effect/turf_decal/trimline/blue/filled/line{
	dir = 1
	},
/obj/structure/cable,
/obj/machinery/power/apc/auto_name/north,
/turf/open/floor/plasteel/white,
/area/medical/chemistry)
"xM" = (
/obj/effect/turf_decal/trimline/blue/filled/line,
/obj/machinery/atmospherics/pipe/smart/manifold4w/scrubbers/hidden/layer2{
	dir = 8
	},
/obj/machinery/atmospherics/pipe/smart/manifold4w/supply/hidden/layer4,
/obj/structure/cable,
/obj/item/radio/intercom{
	pixel_y = -35
	},
/turf/open/floor/plasteel/white,
/area/medical/chemistry)
"ys" = (
/obj/machinery/holopad,
/turf/open/floor/plasteel/monofloor/white,
/area/medical/medbay/zone2)
"yu" = (
/obj/effect/turf_decal/trimline/blue/filled/line{
	dir = 1
	},
/obj/machinery/chem_dispenser,
/obj/structure/extinguisher_cabinet{
	pixel_x = 5;
	pixel_y = 30
	},
/turf/open/floor/plasteel/white,
/area/medical/chemistry)
"yL" = (
/obj/machinery/atmospherics/pipe/smart/manifold4w/scrubbers/hidden/layer2{
	dir = 8
	},
/obj/machinery/atmospherics/pipe/smart/manifold4w/supply/hidden/layer4,
/obj/structure/cable,
/obj/effect/turf_decal/trimline/blue/filled/line{
	dir = 6
	},
/obj/structure/table/glass,
/obj/item/wrench/medical{
	pixel_x = -6;
	pixel_y = 13
	},
/obj/item/reagent_containers/glass/beaker/cryoxadone{
	pixel_x = 7;
	pixel_y = 9
	},
/obj/item/reagent_containers/glass/beaker/cryoxadone{
	pixel_y = 5
	},
/obj/item/reagent_containers/glass/beaker/cryoxadone{
	pixel_x = 7;
	pixel_y = 1
	},
/obj/item/reagent_containers/glass/beaker/cryoxadone{
	pixel_x = -7;
	pixel_y = 1
	},
/obj/item/storage/pill_bottle/mannitol{
	pixel_y = -3
	},
/turf/open/floor/plasteel/white,
/area/medical/medbay/zone2)
"zM" = (
/obj/machinery/atmospherics/components/unary/vent_pump/on/layer4,
/obj/structure/railing{
	dir = 8
	},
/turf/open/floor/plasteel/monofloor/white,
/area/medical/medbay/zone2)
"AP" = (
/obj/machinery/atmospherics/components/unary/portables_connector/visible,
/obj/machinery/portable_atmospherics/canister/oxygen,
/obj/item/wrench/medical,
/obj/effect/turf_decal/trimline/blue/filled/line{
	dir = 1
	},
/obj/machinery/camera/autoname,
/turf/open/floor/plasteel/white,
/area/medical/medbay/zone2)
"AQ" = (
/obj/effect/turf_decal/trimline/blue/filled/line{
	dir = 1
	},
/obj/machinery/chem_heater,
/obj/machinery/camera{
	c_tag = "Chemistry Lab North";
	network = list("ss13","medbay")
	},
/turf/open/floor/plasteel/white,
/area/medical/chemistry)
"Cb" = (
/turf/closed/wall/r_wall,
/area/medical/chemistry)
"CE" = (
/obj/machinery/atmospherics/pipe/smart/manifold4w/scrubbers/hidden/layer2{
	dir = 8
	},
/turf/open/floor/plasteel/monofloor/white,
/area/medical/chemistry)
"CT" = (
/obj/effect/turf_decal/trimline/blue/filled/line,
/obj/machinery/atmospherics/pipe/smart/manifold4w/scrubbers/hidden/layer2{
	dir = 8
	},
/obj/machinery/atmospherics/pipe/smart/manifold4w/supply/hidden/layer4,
/obj/structure/cable,
/turf/open/floor/plasteel/white,
/area/medical/chemistry)
"Df" = (
/obj/structure/stairs/north,
/turf/open/floor/plasteel/monofloor/white,
/area/medical/medbay/zone2)
"EH" = (
/obj/machinery/light,
/obj/machinery/power/apc/auto_name/south,
/obj/structure/cable,
/obj/machinery/atmospherics/pipe/smart/manifold4w/scrubbers/hidden/layer2{
	dir = 8
	},
/turf/open/floor/carpet/blue,
/area/medical/psychology)
"EO" = (
/obj/effect/turf_decal/trimline/blue/filled/line,
/obj/machinery/atmospherics/pipe/smart/manifold4w/supply/hidden/layer4,
/obj/structure/railing/corner{
	dir = 1
	},
/turf/open/floor/plasteel/white,
/area/medical/medbay/zone2)
"Fb" = (
/turf/closed/wall/r_wall,
/area/medical/medbay/zone2)
"Fd" = (
/obj/effect/turf_decal/trimline/blue/filled/line{
	dir = 10
	},
/turf/open/floor/plasteel/white,
/area/medical/chemistry)
"Fm" = (
/obj/effect/turf_decal/trimline/blue/filled/line{
	dir = 6
	},
/obj/machinery/atmospherics/pipe/smart/manifold4w/supply/hidden/layer4,
/obj/machinery/atmospherics/pipe/smart/manifold4w/scrubbers/hidden/layer2{
	dir = 8
	},
/obj/structure/cable,
/turf/open/floor/plasteel/white,
/area/medical/chemistry)
"FW" = (
/obj/machinery/airalarm{
	dir = 8;
	pixel_x = 23
	},
/obj/structure/chair/sofa/left{
	dir = 8
	},
/turf/open/floor/carpet/blue,
/area/medical/psychology)
"Hp" = (
/obj/effect/turf_decal/trimline/blue/filled/line,
/obj/machinery/atmospherics/pipe/smart/manifold4w/scrubbers/hidden/layer2{
	dir = 8
	},
/obj/machinery/atmospherics/pipe/smart/manifold4w/supply/hidden/layer4,
/obj/machinery/power/apc/auto_name/south,
/obj/structure/cable,
/turf/open/floor/plasteel/white,
/area/medical/medbay/zone2)
"HV" = (
/obj/machinery/atmospherics/components/unary/vent_pump/on/layer4,
/turf/open/floor/plasteel/monofloor/white,
/area/medical/chemistry)
"JJ" = (
/obj/effect/turf_decal/trimline/blue/filled/line{
	dir = 1
	},
/obj/machinery/atmospherics/components/unary/vent_pump/on/layer4,
/turf/open/floor/plasteel/white,
/area/medical/chemistry)
"JK" = (
/obj/structure/table/wood,
/obj/item/paper_bin/carbon,
/obj/item/pen,
/obj/item/radio/intercom{
	pixel_y = -35
	},
/turf/open/floor/plasteel/monofloor/white,
/area/medical/psychology)
"LR" = (
/obj/effect/turf_decal/trimline/blue/filled/line,
/obj/machinery/light,
/obj/structure/cable,
/turf/open/floor/plasteel/white,
/area/medical/chemistry)
"No" = (
/obj/machinery/atmospherics/components/unary/portables_connector/visible,
/obj/machinery/portable_atmospherics/canister/oxygen,
/obj/effect/turf_decal/trimline/blue/filled/line{
	dir = 9
	},
/obj/structure/sign/warning/nosmoking/circle{
	pixel_x = -32
	},
/turf/open/floor/plasteel/white,
/area/medical/medbay/zone2)
"Nx" = (
/obj/structure/chair/sofa/right{
	dir = 8
	},
/obj/item/toy/plush/moth,
/turf/open/floor/carpet/blue,
/area/medical/psychology)
"Ob" = (
/obj/effect/turf_decal/trimline/blue/filled/line{
	dir = 1
	},
/obj/machinery/chem_mass_spec,
/turf/open/floor/plasteel/white,
/area/medical/chemistry)
"Oe" = (
/obj/machinery/atmospherics/components/unary/vent_scrubber/on/layer2,
/turf/open/floor/plasteel/monofloor/white,
/area/medical/chemistry)
"Pe" = (
/obj/machinery/holopad,
/turf/open/floor/plasteel/monofloor/white,
/area/medical/chemistry)
"Pk" = (
/obj/structure/extinguisher_cabinet{
	pixel_x = -5;
	pixel_y = 30
	},
/obj/structure/chair/office/light{
	dir = 8
	},
/obj/effect/landmark/start/psychologist,
/turf/open/floor/plasteel/monofloor/white,
/area/medical/psychology)
"Qg" = (
/obj/machinery/atmospherics/pipe/smart/manifold4w/supply/hidden/layer4,
/obj/machinery/atmospherics/pipe/smart/manifold4w/scrubbers/hidden/layer2{
	dir = 8
	},
/obj/structure/cable,
/obj/structure/bookcase/random/reference,
/turf/open/floor/plating,
/area/medical/psychology)
"Qn" = (
/obj/structure/chair/office/light{
	dir = 1
	},
/obj/effect/landmark/start/chemist,
/turf/open/floor/plasteel/monofloor/white,
/area/medical/chemistry)
"RC" = (
/obj/machinery/atmospherics/components/unary/thermomachine/freezer,
/obj/effect/turf_decal/trimline/blue/filled/line{
	dir = 1
	},
/obj/structure/sign/warning/coldtemp{
	pixel_y = 32
	},
/turf/open/floor/plasteel/white,
/area/medical/medbay/zone2)
"RS" = (
/obj/machinery/door/airlock/medical/glass{
	name = "Chemistry Storage";
	req_access_txt = "33"
	},
/obj/machinery/door/firedoor/border_only,
/obj/machinery/door/firedoor/border_only{
	dir = 1
	},
/obj/machinery/atmospherics/pipe/smart/manifold4w/scrubbers/hidden/layer2{
	dir = 8
	},
/obj/machinery/atmospherics/pipe/smart/manifold4w/supply/hidden/layer4,
/obj/structure/cable,
/turf/open/floor/plasteel/white,
/area/medical/chemistry)
"RU" = (
/obj/machinery/atmospherics/components/unary/vent_scrubber/on/layer2,
/turf/open/floor/carpet/blue,
/area/medical/psychology)
"Sl" = (
/obj/machinery/light{
	dir = 1;
	pixel_y = 0
	},
/turf/open/floor/plasteel/monofloor/white,
/area/medical/psychology)
"SA" = (
/obj/effect/turf_decal/trimline/blue/filled/corner{
	dir = 4
	},
/turf/open/floor/plasteel/white,
/area/medical/chemistry)
"SX" = (
/obj/effect/turf_decal/trimline/blue/filled/line{
	dir = 1
	},
/obj/structure/table,
/obj/machinery/reagentgrinder,
/obj/item/stack/sheet/mineral/plasma,
/turf/open/floor/plasteel/white,
/area/medical/chemistry)
"Te" = (
/obj/effect/turf_decal/trimline/blue/filled/line{
	dir = 1
	},
/obj/machinery/light{
	dir = 1;
	pixel_y = 0
	},
/obj/machinery/chem_master,
/turf/open/floor/plasteel/white,
/area/medical/chemistry)
"To" = (
/turf/open/floor/plasteel/monofloor/white,
/area/medical/psychology)
"Ud" = (
/obj/machinery/atmospherics/pipe/smart/manifold4w/supply/hidden/layer4,
/obj/machinery/atmospherics/pipe/smart/manifold4w/scrubbers/hidden/layer2{
	dir = 8
	},
/obj/structure/cable,
/obj/structure/sign/departments/psychology{
	pixel_y = -32
	},
/obj/machinery/door/airlock/medical{
	name = "Psychology";
	req_access_txt = "70"
	},
/obj/machinery/door/firedoor/border_only{
	dir = 4
	},
/obj/machinery/door/firedoor/border_only{
	dir = 8
	},
/turf/open/floor/plasteel/monofloor/white,
/area/medical/psychology)
"VX" = (
/obj/machinery/atmospherics/pipe/smart/manifold4w/supply/hidden/layer4,
/obj/machinery/atmospherics/pipe/smart/manifold4w/scrubbers/hidden/layer2{
	dir = 8
	},
/obj/structure/cable,
/turf/open/floor/carpet/blue,
/area/medical/psychology)
"WM" = (
/obj/machinery/door/airlock/maintenance{
	dir = 4;
	name = "Medbay Maintenance";
	req_access_txt = "5"
	},
/obj/structure/cable,
/obj/machinery/atmospherics/pipe/smart/manifold4w/scrubbers/hidden/layer2{
	dir = 8
	},
/obj/machinery/atmospherics/pipe/smart/manifold4w/supply/hidden/layer4,
/obj/effect/mapping_helpers/airlock/locked,
/obj/machinery/door/firedoor/border_only{
	dir = 4
	},
/obj/machinery/door/firedoor/border_only{
	dir = 8
	},
/turf/open/floor/plating,
/area/medical/psychology)
"Xd" = (
/obj/machinery/holopad,
/turf/open/floor/carpet/blue,
/area/medical/psychology)
"YD" = (
/obj/effect/turf_decal/trimline/blue/filled/line{
	dir = 10
	},
/turf/open/floor/plasteel/white,
/area/medical/medbay/zone2)
"Zd" = (
/obj/structure/cable,
/turf/open/floor/plasteel/monofloor/white,
/area/medical/medbay/zone2)
"Zp" = (
/obj/effect/turf_decal/trimline/blue/filled/line{
	dir = 1
	},
/turf/open/floor/plasteel/white,
/area/medical/chemistry)

(1,1,1) = {"
tI
tI
tI
tI
tI
tI
tI
tI
tI
tI
tI
tI
tI
tI
tI
tI
tI
tI
tI
tI
tI
tI
tI
tI
tI
tI
tI
tI
tI
tI
tI
tI
tI
tI
tI
tI
tI
tI
tI
tI
"}
(2,1,1) = {"
tI
tI
tI
tI
tI
tI
tI
tI
tI
tI
tI
tI
tI
tI
tI
tI
tI
tI
tI
tI
tI
tI
tI
tI
tI
tI
tI
tI
tI
tI
tI
tI
tI
tI
tI
tI
tI
tI
tI
tI
"}
(3,1,1) = {"
tI
tI
tI
tI
tI
tI
tI
tI
tI
tI
tI
tI
tI
tI
tI
tI
tI
tI
tI
tI
tI
tI
tI
tI
tI
tI
tI
tI
tI
tI
tI
tI
tI
tI
tI
tI
tI
tI
tI
tI
"}
(4,1,1) = {"
tI
tI
tI
tI
tI
tI
tI
tI
tI
Cb
Cb
Cb
Cb
Cb
Cb
tI
tI
tI
tI
tI
tI
tI
tI
tI
tI
tI
tI
tI
tI
tI
tI
tI
tI
tI
tI
tI
tI
tI
tI
tI
"}
(5,1,1) = {"
tI
tI
tI
tI
tI
tI
tI
tI
tI
Cb
bt
ge
ge
Fd
jN
tI
tI
tI
tI
tI
tI
tI
tI
tI
tI
tI
tI
tI
tI
tI
tI
tI
tI
tI
tI
tI
tI
tI
tI
tI
"}
(6,1,1) = {"
tI
tI
tI
tI
tI
tI
tI
tI
tI
Cb
xJ
xl
xl
LR
Cb
tI
tI
tI
tI
tI
tI
tI
tI
tI
tI
tI
tI
tI
tI
tI
tI
tI
tI
tI
tI
tI
tI
tI
tI
tI
"}
(7,1,1) = {"
tI
tI
tI
tI
tI
tI
tI
tI
tI
Cb
Ob
Pe
ir
fE
Cb
tI
tI
tI
tI
tI
tI
tI
tI
tI
tI
tI
tI
tI
tI
tI
tI
tI
tI
tI
tI
tI
tI
tI
tI
tI
"}
(8,1,1) = {"
tI
tI
tI
tI
tI
tI
tI
tI
tI
Cb
ru
ir
HV
CT
Cb
tI
tI
tI
tI
tI
tI
tI
tI
tI
tI
tI
tI
tI
tI
tI
tI
tI
tI
tI
tI
tI
tI
tI
tI
tI
"}
(9,1,1) = {"
tI
tI
tI
tI
tI
tI
tI
tI
tI
Cb
AQ
ir
ir
xM
Cb
tI
tI
tI
tI
tI
tI
tI
tI
tI
tI
tI
tI
tI
tI
tI
tI
tI
tI
tI
tI
tI
tI
tI
tI
tI
"}
(10,1,1) = {"
tI
tI
tI
tI
tI
tI
tI
tI
tI
Cb
yu
Qn
ir
CT
Cb
Fb
Fb
Fb
Fb
Fb
tI
tI
tI
tI
tI
tI
tI
tI
tI
tI
tI
tI
tI
tI
tI
tI
tI
tI
tI
tI
"}
(11,1,1) = {"
tI
tI
tI
tI
tI
tI
tI
tI
tI
Cb
Te
ir
ir
sl
Cb
No
lX
jI
YD
Fb
tI
tI
tI
tI
tI
tI
tI
tI
tI
tI
tI
tI
tI
tI
tI
tI
tI
tI
tI
tI
"}
(12,1,1) = {"
tI
tI
tI
tI
tI
tI
tI
tI
tI
Cb
SX
Oe
CE
CT
Cb
AP
ob
Df
em
Fb
tI
tI
tI
tI
tI
tI
tI
tI
tI
tI
tI
tI
tI
tI
tI
tI
tI
tI
tI
tI
"}
(13,1,1) = {"
tI
tI
tI
tI
tI
tI
tI
tI
tI
Cb
vQ
hj
SA
CT
Cb
oe
su
zM
EO
Fb
tI
tI
tI
tI
tI
tI
tI
tI
tI
tI
tI
tI
tI
tI
tI
tI
tI
tI
tI
tI
"}
(14,1,1) = {"
tI
tI
tI
tI
tI
tI
tI
tI
tI
Cb
Cb
Cb
Zp
CT
Cb
RC
oH
pt
uR
Fb
tI
tI
tI
tI
tI
tI
tI
tI
tI
tI
tI
tI
tI
tI
tI
tI
tI
tI
tI
tI
"}
(15,1,1) = {"
tI
tI
tI
tI
tI
tI
tI
tI
tI
tI
tI
Cb
JJ
CT
Cb
oe
oH
uk
Hp
Fb
tI
tI
tI
tI
tI
tI
tI
tI
tI
tI
tI
tI
tI
tI
tI
tI
tI
tI
tI
tI
"}
(16,1,1) = {"
tI
tI
tI
tI
tI
tI
tI
tI
tI
tI
tI
Cb
vY
Fm
RS
qp
Zd
ys
xH
Fb
tI
tI
tI
tI
tI
tI
tI
tI
tI
tI
tI
tI
tI
tI
tI
tI
tI
tI
tI
tI
"}
(17,1,1) = {"
tI
tI
tI
tI
tI
tI
tI
tI
tI
tI
tI
tG
tG
tG
tG
iW
hG
hG
yL
Fb
tI
tI
tI
tI
tI
tI
tI
tI
tI
tI
tI
tI
tI
tI
tI
tI
tI
tI
tI
tI
"}
(18,1,1) = {"
tI
tI
tI
tI
tI
tI
tI
tI
tI
tI
tI
tG
pR
JK
tG
tG
Ud
tG
tG
tG
tI
tI
tI
tI
tI
tI
tI
tI
tI
tI
tI
tI
tI
tI
tI
tI
tI
tI
tI
tI
"}
(19,1,1) = {"
tI
tI
tI
tI
tI
tI
tI
tI
tI
tI
tI
tG
Pk
fa
gL
gL
VX
Qg
fc
tG
tI
tI
tI
tI
tI
tI
tI
tI
tI
tI
tI
tI
tI
tI
tI
tI
tI
tI
tI
tI
"}
(20,1,1) = {"
tI
tI
tI
tI
tI
tI
tI
tI
tI
tI
tI
tG
Sl
To
Xd
RU
EH
tG
WM
tG
tI
tI
tI
tI
tI
tI
tI
tI
tI
tI
tI
tI
tI
tI
tI
tI
tI
tI
tI
tI
"}
(21,1,1) = {"
tI
tI
tI
tI
tI
tI
tI
tI
tI
tI
tI
tG
ee
qT
Nx
cd
FW
tG
tI
tI
tI
tI
tI
tI
tI
tI
tI
tI
tI
tI
tI
tI
tI
tI
tI
tI
tI
tI
tI
tI
"}
(22,1,1) = {"
tI
tI
tI
tI
tI
tI
tI
tI
tI
tI
tI
tG
tG
tG
tG
tG
tG
tG
tI
tI
tI
tI
tI
tI
tI
tI
tI
tI
tI
tI
tI
tI
tI
tI
tI
tI
tI
tI
tI
tI
"}
(23,1,1) = {"
tI
tI
tI
tI
tI
tI
tI
tI
tI
tI
tI
tI
tI
tI
tI
tI
tI
tI
tI
tI
tI
tI
tI
tI
tI
tI
tI
tI
tI
tI
tI
tI
tI
tI
tI
tI
tI
tI
tI
tI
"}
(24,1,1) = {"
tI
tI
tI
tI
tI
tI
tI
tI
tI
tI
tI
tI
tI
tI
tI
tI
tI
tI
tI
tI
tI
tI
tI
tI
tI
tI
tI
tI
tI
tI
tI
tI
tI
tI
tI
tI
tI
tI
tI
tI
"}
(25,1,1) = {"
tI
tI
tI
tI
tI
tI
tI
tI
tI
tI
tI
tI
tI
tI
tI
tI
tI
tI
tI
tI
tI
tI
tI
tI
tI
tI
tI
tI
tI
tI
tI
tI
tI
tI
tI
tI
tI
tI
tI
tI
"}
(26,1,1) = {"
tI
tI
tI
tI
tI
tI
tI
tI
tI
tI
tI
tI
tI
tI
tI
tI
tI
tI
tI
tI
tI
tI
tI
tI
tI
tI
tI
tI
tI
tI
tI
tI
tI
tI
tI
tI
tI
tI
tI
tI
"}
(27,1,1) = {"
tI
tI
tI
tI
tI
tI
tI
tI
tI
tI
tI
tI
tI
tI
tI
tI
tI
tI
tI
tI
tI
tI
tI
tI
tI
tI
tI
tI
tI
tI
tI
tI
tI
tI
tI
tI
tI
tI
tI
tI
"}
(28,1,1) = {"
tI
tI
tI
tI
tI
tI
tI
tI
tI
tI
tI
tI
tI
tI
tI
tI
tI
tI
tI
tI
tI
tI
tI
tI
tI
tI
tI
tI
tI
tI
tI
tI
tI
tI
tI
tI
tI
tI
tI
tI
"}
(29,1,1) = {"
tI
tI
tI
tI
tI
tI
tI
tI
tI
tI
tI
tI
tI
tI
tI
tI
tI
tI
tI
tI
tI
tI
tI
tI
tI
tI
tI
tI
tI
tI
tI
tI
tI
tI
tI
tI
tI
tI
tI
tI
"}
(30,1,1) = {"
tI
tI
tI
tI
tI
tI
tI
tI
tI
tI
tI
tI
tI
tI
tI
tI
tI
tI
tI
tI
tI
tI
tI
tI
tI
tI
tI
tI
tI
tI
tI
tI
tI
tI
tI
tI
tI
tI
tI
tI
"}
(31,1,1) = {"
tI
tI
tI
tI
tI
tI
tI
tI
tI
tI
tI
tI
tI
tI
tI
tI
tI
tI
tI
tI
tI
tI
tI
tI
tI
tI
tI
tI
tI
tI
tI
tI
tI
tI
tI
tI
tI
tI
tI
tI
"}
(32,1,1) = {"
tI
tI
tI
tI
tI
tI
tI
tI
tI
tI
tI
tI
tI
tI
tI
tI
tI
tI
tI
tI
tI
tI
tI
tI
tI
tI
tI
tI
tI
tI
tI
tI
tI
tI
tI
tI
tI
tI
tI
tI
"}
