//MAP CONVERTED BY dmm2tgm.py THIS HEADER COMMENT PREVENTS RECONVERSION, DO NOT REMOVE
"a" = (
/obj/structure/table,
/obj/item/flashlight/lamp,
/obj/effect/decal/cleanable/cobweb,
/obj/effect/turf_decal/tile/blue{
	dir = 1
	},
/obj/effect/turf_decal/tile/blue,
/obj/effect/turf_decal/tile/blue{
	dir = 4
	},
/obj/effect/turf_decal/tile/blue{
	dir = 8
	},
/obj/effect/decal/cleanable/dirt,
/turf/open/floor/plasteel/white,
/area/template_noop)
"b" = (
/obj/effect/turf_decal/tile/blue{
	dir = 1
	},
/obj/effect/turf_decal/tile/blue,
/obj/effect/turf_decal/tile/blue{
	dir = 4
	},
/obj/effect/turf_decal/tile/blue{
	dir = 8
	},
/obj/machinery/computer/scan_consolenew,
/turf/open/floor/plasteel/white,
/area/template_noop)
"c" = (
/obj/effect/turf_decal/tile/blue{
	dir = 1
	},
/obj/effect/turf_decal/tile/blue,
/obj/effect/turf_decal/tile/blue{
	dir = 4
	},
/obj/effect/turf_decal/tile/blue{
	dir = 8
	},
/obj/machinery/dna_scannernew,
/turf/open/floor/plasteel/white,
/area/template_noop)
"e" = (
/obj/machinery/light{
	dir = 1
	},
/obj/effect/turf_decal/tile/blue{
	dir = 1
	},
/obj/effect/turf_decal/tile/blue,
/obj/effect/turf_decal/tile/blue{
	dir = 4
	},
/obj/effect/turf_decal/tile/blue{
	dir = 8
	},
/obj/effect/decal/cleanable/cobweb/cobweb2,
/turf/open/floor/plasteel/white,
/area/template_noop)
"f" = (
/obj/effect/turf_decal/tile/blue{
	dir = 1
	},
/obj/effect/turf_decal/tile/blue{
	dir = 4
	},
/turf/open/floor/plasteel/white,
/area/template_noop)
"g" = (
/obj/structure/chair{
	dir = 1
	},
/obj/effect/turf_decal/tile/blue{
	dir = 1
	},
/obj/effect/turf_decal/tile/blue{
	dir = 4
	},
/obj/effect/decal/cleanable/dirt,
/turf/open/floor/plasteel/white,
/area/template_noop)
"h" = (
/turf/open/floor/plating,
/area/template_noop)
"i" = (
/obj/structure/closet,
/obj/effect/decal/cleanable/dirt,
/turf/open/floor/plasteel/white,
/area/template_noop)
"j" = (
/turf/open/floor/plasteel/white,
/area/template_noop)
"k" = (
/obj/effect/turf_decal/tile/blue{
	dir = 1
	},
/obj/effect/turf_decal/tile/blue,
/obj/effect/turf_decal/tile/blue{
	dir = 4
	},
/obj/effect/turf_decal/tile/blue{
	dir = 8
	},
/obj/effect/decal/cleanable/dirt,
/turf/open/floor/plasteel/white,
/area/template_noop)
"x" = (
/obj/effect/turf_decal/tile/blue{
	dir = 1
	},
/obj/effect/turf_decal/tile/blue{
	dir = 4
	},
/obj/effect/decal/cleanable/dirt,
/turf/open/floor/plasteel/white,
/area/template_noop)
"O" = (
/obj/effect/decal/cleanable/dirt,
/turf/open/floor/plasteel/white,
/area/template_noop)
"X" = (
/obj/effect/decal/cleanable/dirt,
/turf/open/floor/plating,
/area/template_noop)

(1,1,1) = {"
a
f
i
"}
(2,1,1) = {"
b
g
h
"}
(3,1,1) = {"
c
h
X
"}
(4,1,1) = {"
k
x
j
"}
(5,1,1) = {"
e
h
O
"}
