//MAP CONVERTED BY dmm2tgm.py THIS HEADER COMMENT PREVENTS RECONVERSION, DO NOT REMOVE
"a" = (
/obj/structure/table,
/obj/effect/spawner/lootdrop/gloves,
/obj/effect/decal/cleanable/dirt,
/obj/item/clothing/gloves/color/fyellow/old,
/turf/open/floor/plasteel/grimy,
/area/template_noop)
"b" = (
/obj/structure/table,
/obj/machinery/light/small/broken{
	dir = 1;
	icon_state = "bulb-broken"
	},
/obj/effect/spawner/lootdrop/gloves,
/obj/effect/decal/cleanable/dirt,
/turf/open/floor/plasteel/grimy,
/area/template_noop)
"c" = (
/obj/effect/decal/cleanable/dirt,
/turf/open/floor/plasteel/grimy,
/area/template_noop)
"d" = (
/obj/structure/closet,
/obj/effect/spawner/lootdrop/gloves,
/obj/effect/decal/cleanable/dirt,
/turf/open/floor/plasteel/grimy,
/area/template_noop)
"f" = (
/obj/structure/closet/crate,
/obj/effect/spawner/lootdrop/gloves,
/obj/effect/decal/cleanable/dirt,
/turf/open/floor/plasteel/grimy,
/area/template_noop)
"g" = (
/obj/structure/table,
/obj/machinery/light/small/broken,
/obj/effect/spawner/lootdrop/gloves,
/obj/effect/decal/cleanable/dirt,
/obj/item/clothing/gloves/color/fyellow/old,
/turf/open/floor/plasteel/grimy,
/area/template_noop)
"y" = (
/obj/structure/closet,
/obj/effect/spawner/lootdrop/gloves,
/obj/effect/decal/cleanable/dirt,
/obj/item/clothing/gloves/color/yellow,
/turf/open/floor/plasteel/grimy,
/area/template_noop)
"H" = (
/obj/structure/table,
/obj/effect/spawner/lootdrop/gloves,
/obj/effect/decal/cleanable/dirt,
/obj/item/clothing/gloves/color/fyellow,
/turf/open/floor/plasteel/grimy,
/area/template_noop)

(1,1,1) = {"
a
c
H
"}
(2,1,1) = {"
b
c
f
"}
(3,1,1) = {"
c
c
c
"}
(4,1,1) = {"
y
c
g
"}
(5,1,1) = {"
d
c
f
"}
