//MAP CONVERTED BY dmm2tgm.py THIS HEADER COMMENT PREVENTS RECONVERSION, DO NOT REMOVE
"a" = (
/turf/template_noop,
/area/template_noop)
"k" = (
/turf/open/floor/plating/asteroid/airless,
/area/ruin/unpowered/no_grav)
"C" = (
/obj/effect/decal/cleanable/blood/old,
/obj/effect/mob_spawn/human/corpse/assistant,
/turf/open/floor/plating/asteroid/airless,
/area/ruin/unpowered/no_grav)
"N" = (
/obj/item/melee/energy/sword/saber/blue,
/turf/open/floor/plating/asteroid/airless,
/area/ruin/unpowered/no_grav)
"R" = (
/obj/effect/decal/cleanable/blood/old{
	icon_state = "gib4-old"
	},
/turf/open/floor/plating/asteroid/airless,
/area/ruin/unpowered/no_grav)
"W" = (
/turf/closed/mineral/random/high_chance,
/area/ruin/unpowered/no_grav)
"X" = (
/turf/closed/mineral/random,
/area/ruin/unpowered/no_grav)

(1,1,1) = {"
a
a
k
k
a
a
a
"}
(2,1,1) = {"
a
X
X
X
k
k
a
"}
(3,1,1) = {"
a
X
X
k
R
k
a
"}
(4,1,1) = {"
k
X
k
C
X
X
k
"}
(5,1,1) = {"
k
X
X
N
W
W
k
"}
(6,1,1) = {"
a
k
X
X
W
k
k
"}
(7,1,1) = {"
a
a
k
k
k
a
a
"}
