//MAP CONVERTED BY dmm2tgm.py THIS HEADER COMMENT PREVENTS RECONVERSION, DO NOT REMOVE
"a" = (
/turf/template_noop,
/area/template_noop)
"b" = (
/turf/closed/wall/mineral/titanium,
/area/shuttle/arrival)
"c" = (
/obj/machinery/door/airlock/titanium{
	name = "Arrivals Shuttle Airlock"
	},
/obj/structure/fans/tiny,
/turf/open/floor/plating,
/area/shuttle/arrival)
"d" = (
/obj/effect/spawner/structure/window/shuttle,
/turf/open/floor/plating,
/area/shuttle/arrival)
"e" = (
/obj/structure/table,
/obj/item/storage/firstaid/fire,
/obj/item/storage/firstaid/regular{
	pixel_x = 2;
	pixel_y = 3
	},
/obj/item/crowbar,
/obj/structure/extinguisher_cabinet{
	pixel_x = -27;
	pixel_y = 1
	},
/obj/structure/window/reinforced{
	dir = 4
	},
/turf/open/floor/mineral/titanium/blue,
/area/shuttle/arrival)
"f" = (
/turf/open/floor/mineral/titanium/blue,
/area/shuttle/arrival)
"g" = (
/obj/effect/spawner/randomarcade,
/obj/machinery/light{
	dir = 1
	},
/turf/open/floor/mineral/titanium/blue,
/area/shuttle/arrival)
"h" = (
/obj/structure/closet/wardrobe/green{
	anchored = 1
	},
/turf/open/floor/mineral/titanium/blue,
/area/shuttle/arrival)
"i" = (
/obj/structure/closet/wardrobe/black{
	anchored = 1
	},
/turf/open/floor/mineral/titanium/blue,
/area/shuttle/arrival)
"j" = (
/obj/structure/closet/wardrobe/mixed{
	anchored = 1
	},
/turf/open/floor/mineral/titanium/blue,
/area/shuttle/arrival)
"k" = (
/obj/structure/closet/wardrobe/grey{
	anchored = 1
	},
/turf/open/floor/mineral/titanium/blue,
/area/shuttle/arrival)
"l" = (
/obj/machinery/requests_console{
	department = "Arrival shuttle";
	name = "Arrivals Shuttle console";
	pixel_y = 30
	},
/obj/machinery/light{
	dir = 1
	},
/obj/structure/closet/firecloset,
/turf/open/floor/mineral/titanium/blue,
/area/shuttle/arrival)
"m" = (
/obj/structure/shuttle/engine/heater{
	dir = 4
	},
/obj/structure/window/reinforced{
	dir = 8
	},
/turf/open/floor/plating/airless,
/area/shuttle/arrival)
"n" = (
/obj/structure/shuttle/engine/propulsion/burst/right{
	dir = 4
	},
/turf/open/floor/plating/airless,
/area/shuttle/arrival)
"o" = (
/obj/machinery/computer/shuttle_flight{
	dir = 4
	},
/turf/open/floor/mineral/titanium/blue,
/area/shuttle/arrival)
"p" = (
/obj/structure/chair/comfy/shuttle{
	dir = 8
	},
/obj/item/radio/intercom{
	pixel_x = 29
	},
/obj/machinery/light{
	dir = 4;
	icon_state = "tube"
	},
/turf/open/floor/mineral/titanium/blue,
/area/shuttle/arrival)
"q" = (
/obj/machinery/vending/wallmed{
	name = "Emergency NanoMed";
	use_power = 0
	},
/turf/closed/wall/mineral/titanium,
/area/shuttle/arrival)
"r" = (
/obj/structure/chair/comfy/shuttle{
	dir = 8
	},
/turf/open/floor/mineral/titanium,
/area/shuttle/arrival)
"s" = (
/obj/structure/shuttle/engine/propulsion{
	dir = 4
	},
/turf/open/floor/plating/airless,
/area/shuttle/arrival)
"t" = (
/obj/machinery/door/airlock/titanium{
	name = "Arrivals Shuttle Airlock"
	},
/obj/structure/cable,
/turf/open/floor/mineral/titanium,
/area/shuttle/arrival)
"u" = (
/obj/structure/shuttle/engine/propulsion{
	dir = 4
	},
/obj/docking_port/mobile/arrivals,
/turf/open/floor/plating/airless,
/area/shuttle/arrival)
"v" = (
/obj/machinery/computer/crew{
	dir = 4
	},
/turf/open/floor/mineral/titanium/blue,
/area/shuttle/arrival)
"w" = (
/obj/machinery/computer/monitor{
	dir = 4
	},
/obj/structure/cable,
/turf/open/floor/mineral/titanium/blue,
/area/shuttle/arrival)
"x" = (
/obj/structure/closet/emcloset{
	anchored = 1
	},
/turf/open/floor/mineral/titanium/blue,
/area/shuttle/arrival)
"y" = (
/obj/structure/chair/comfy/shuttle{
	dir = 8
	},
/obj/structure/extinguisher_cabinet{
	pixel_x = 27
	},
/obj/machinery/light{
	dir = 4;
	icon_state = "tube"
	},
/obj/structure/cable,
/turf/open/floor/mineral/titanium/blue,
/area/shuttle/arrival)
"z" = (
/obj/item/radio/intercom{
	name = "Station Intercom (General)";
	pixel_y = -29
	},
/obj/machinery/light,
/turf/open/floor/mineral/titanium/blue,
/area/shuttle/arrival)
"A" = (
/obj/structure/shuttle/engine/propulsion/burst/left{
	dir = 4
	},
/turf/open/floor/plating/airless,
/area/shuttle/arrival)
"B" = (
/obj/machinery/light,
/turf/open/floor/mineral/titanium/blue,
/area/shuttle/arrival)
"C" = (
/obj/machinery/light_switch{
	pixel_x = 6
	},
/turf/closed/wall/mineral/titanium,
/area/shuttle/arrival)
"D" = (
/obj/structure/cable,
/turf/open/floor/mineral/titanium/blue,
/area/shuttle/arrival)
"O" = (
/obj/structure/cable,
/turf/open/floor/mineral/titanium,
/area/shuttle/arrival)
"Q" = (
/obj/structure/chair/comfy/shuttle{
	dir = 8
	},
/obj/structure/cable,
/turf/open/floor/mineral/titanium,
/area/shuttle/arrival)
"S" = (
/turf/open/floor/mineral/titanium,
/area/shuttle/arrival)
"U" = (
/obj/machinery/door/airlock/titanium{
	name = "Arrivals Shuttle Airlock"
	},
/obj/structure/fans/tiny,
/obj/structure/cable,
/turf/open/floor/plating,
/area/shuttle/arrival)

(1,1,1) = {"
a
b
d
d
d
b
a
"}
(2,1,1) = {"
a
b
v
o
w
b
a
"}
(3,1,1) = {"
a
b
p
O
y
b
a
"}
(4,1,1) = {"
b
b
b
t
C
b
b
"}
(5,1,1) = {"
b
e
S
O
S
x
b
"}
(6,1,1) = {"
c
f
r
Q
Q
D
U
"}
(7,1,1) = {"
b
g
f
f
f
B
q
"}
(8,1,1) = {"
d
h
r
r
r
f
d
"}
(9,1,1) = {"
d
i
f
f
f
f
d
"}
(10,1,1) = {"
d
j
r
r
r
f
d
"}
(11,1,1) = {"
d
k
f
f
f
f
d
"}
(12,1,1) = {"
b
l
r
r
r
z
b
"}
(13,1,1) = {"
c
f
S
S
S
f
c
"}
(14,1,1) = {"
b
m
m
m
m
m
b
"}
(15,1,1) = {"
a
n
s
u
s
A
a
"}
