//MAP CONVERTED BY dmm2tgm.py THIS HEADER COMMENT PREVENTS RECONVERSION, DO NOT REMOVE
"a" = (
/obj/machinery/vending/wallmed{
	name = "Emergency NanoMed";
	use_power = 0
	},
/turf/closed/wall/mineral/titanium,
/area/shuttle/arrival)
"b" = (
/obj/structure/chair/comfy/shuttle{
	dir = 8
	},
/obj/structure/extinguisher_cabinet{
	pixel_x = 27
	},
/obj/machinery/light{
	dir = 4
	},
/turf/open/floor/mineral/titanium/blue,
/area/shuttle/arrival)
"d" = (
/obj/machinery/computer/shuttle_flight{
	dir = 4
	},
/turf/open/floor/mineral/titanium/blue,
/area/shuttle/arrival)
"e" = (
/obj/structure/closet/wardrobe/grey,
/turf/open/floor/mineral/titanium/blue,
/area/shuttle/arrival)
"f" = (
/turf/open/floor/mineral/titanium,
/area/shuttle/arrival)
"h" = (
/obj/structure/chair/comfy/shuttle{
	dir = 8
	},
/turf/open/floor/mineral/titanium,
/area/shuttle/arrival)
"i" = (
/obj/machinery/computer/monitor{
	dir = 4
	},
/turf/open/floor/mineral/titanium/blue,
/area/shuttle/arrival)
"n" = (
/obj/structure/shuttle/engine/propulsion{
	dir = 4
	},
/turf/open/floor/plating/airless,
/area/shuttle/arrival)
"o" = (
/obj/machinery/requests_console{
	department = "Arrival shuttle";
	name = "Arrivals Shuttle console";
	pixel_y = 30
	},
/obj/machinery/light{
	dir = 1
	},
/turf/open/floor/mineral/titanium/blue,
/area/shuttle/arrival)
"p" = (
/obj/structure/table,
/obj/item/storage/firstaid/fire,
/obj/item/storage/firstaid/regular{
	pixel_x = 2;
	pixel_y = 3
	},
/obj/item/crowbar,
/obj/structure/extinguisher_cabinet{
	pixel_x = -27;
	pixel_y = 1
	},
/turf/open/floor/mineral/titanium/blue,
/area/shuttle/arrival)
"q" = (
/obj/structure/shuttle/engine/propulsion{
	dir = 4
	},
/obj/docking_port/mobile/arrivals,
/turf/open/floor/plating/airless,
/area/shuttle/arrival)
"r" = (
/obj/effect/spawner/structure/window/shuttle,
/turf/open/floor/plating,
/area/shuttle/arrival)
"s" = (
/obj/structure/shuttle/engine/heater{
	dir = 4
	},
/obj/structure/window/reinforced{
	dir = 8
	},
/turf/open/floor/plating/airless,
/area/shuttle/arrival)
"t" = (
/turf/open/floor/mineral/titanium/blue,
/area/shuttle/arrival)
"v" = (
/obj/effect/spawner/randomarcade,
/obj/machinery/light{
	dir = 1
	},
/turf/open/floor/mineral/titanium/blue,
/area/shuttle/arrival)
"x" = (
/obj/machinery/light_switch{
	pixel_x = 6
	},
/turf/closed/wall/mineral/titanium,
/area/shuttle/arrival)
"y" = (
/turf/closed/wall/mineral/titanium,
/area/shuttle/arrival)
"A" = (
/obj/machinery/door/airlock/titanium{
	name = "Arrivals Shuttle Airlock"
	},
/turf/open/floor/mineral/titanium,
/area/shuttle/arrival)
"C" = (
/obj/structure/closet/emcloset,
/turf/open/floor/mineral/titanium/blue,
/area/shuttle/arrival)
"D" = (
/obj/structure/closet/wardrobe/mixed,
/turf/open/floor/mineral/titanium/blue,
/area/shuttle/arrival)
"E" = (
/obj/machinery/computer/crew{
	dir = 4
	},
/turf/open/floor/mineral/titanium/blue,
/area/shuttle/arrival)
"G" = (
/obj/structure/closet/wardrobe/green,
/turf/open/floor/mineral/titanium/blue,
/area/shuttle/arrival)
"H" = (
/obj/structure/shuttle/engine/propulsion/burst/left{
	dir = 4
	},
/turf/open/floor/plating/airless,
/area/shuttle/arrival)
"J" = (
/obj/machinery/door/airlock/titanium{
	name = "Arrivals Shuttle Airlock"
	},
/turf/open/floor/plating,
/area/shuttle/arrival)
"N" = (
/obj/structure/shuttle/engine/propulsion/burst/right{
	dir = 4
	},
/turf/open/floor/plating/airless,
/area/shuttle/arrival)
"O" = (
/obj/item/radio/intercom{
	name = "Station Intercom (General)";
	pixel_y = -29
	},
/obj/machinery/light,
/turf/open/floor/mineral/titanium/blue,
/area/shuttle/arrival)
"P" = (
/turf/template_noop,
/area/template_noop)
"R" = (
/obj/structure/chair/comfy/shuttle{
	dir = 8
	},
/obj/item/radio/intercom{
	pixel_x = 29
	},
/obj/machinery/light{
	dir = 4
	},
/turf/open/floor/mineral/titanium/blue,
/area/shuttle/arrival)
"V" = (
/obj/machinery/light,
/turf/open/floor/mineral/titanium/blue,
/area/shuttle/arrival)
"W" = (
/obj/structure/closet/wardrobe/black,
/turf/open/floor/mineral/titanium/blue,
/area/shuttle/arrival)

(1,1,1) = {"
P
y
r
r
r
y
P
"}
(2,1,1) = {"
P
y
E
d
i
y
P
"}
(3,1,1) = {"
P
y
R
f
b
y
P
"}
(4,1,1) = {"
y
y
y
A
x
y
y
"}
(5,1,1) = {"
y
p
f
f
f
C
y
"}
(6,1,1) = {"
y
t
h
h
h
t
J
"}
(7,1,1) = {"
y
v
t
t
t
V
a
"}
(8,1,1) = {"
r
G
h
h
h
t
r
"}
(9,1,1) = {"
r
W
t
t
t
t
r
"}
(10,1,1) = {"
r
D
h
h
h
t
r
"}
(11,1,1) = {"
r
e
t
t
t
t
r
"}
(12,1,1) = {"
y
o
h
h
h
O
y
"}
(13,1,1) = {"
y
t
f
f
f
t
J
"}
(14,1,1) = {"
y
s
s
s
s
s
y
"}
(15,1,1) = {"
y
N
n
q
n
H
y
"}
