//MAP CONVERTED BY dmm2tgm.py THIS HEADER COMMENT PREVENTS RECONVERSION, DO NOT REMOVE
"aa" = (
/turf/template_noop,
/area/template_noop)
"ab" = (
/turf/closed/wall/mineral/titanium,
/area/shuttle/escape/luxury)
"ac" = (
/obj/machinery/door/airlock/external{
	name = "Economy-Class"
	},
/obj/structure/fans/tiny,
/turf/open/floor/plasteel,
/area/shuttle/escape/luxury)
"ad" = (
/obj/machinery/scanner_gate/luxury_shuttle{
	layer = 2.6
	},
/obj/machinery/door/airlock/silver{
	name = "First Class"
	},
/obj/structure/fans/tiny,
/turf/open/floor/carpet/orange,
/area/shuttle/escape/luxury)
"ae" = (
/obj/docking_port/mobile/emergency{
	dir = 2;
	dwidth = 5;
	height = 14;
	name = "Luxurious Emergency Shuttle";
	width = 25
	},
/obj/machinery/scanner_gate/luxury_shuttle{
	layer = 2.6
	},
/obj/machinery/door/airlock/silver{
	name = "First Class"
	},
/obj/structure/fans/tiny,
/turf/open/floor/carpet/orange,
/area/shuttle/escape/luxury)
"af" = (
/obj/machinery/door/airlock/security/glass{
	name = "Escape Shuttle Cell";
	req_access_txt = "2"
	},
/turf/open/floor/mineral/plastitanium/red/brig,
/area/shuttle/escape/brig)
"ag" = (
/turf/closed/indestructible/riveted/plastinum,
/area/shuttle/escape/luxury)
"ah" = (
/obj/effect/turf_decal/delivery,
/obj/structure/ore_box,
/obj/effect/decal/cleanable/cobweb,
/obj/machinery/light/small{
	dir = 1
	},
/turf/open/floor/plasteel,
/area/shuttle/escape/luxury)
"ai" = (
/turf/closed/indestructible/riveted/plastinum,
/area/shuttle/escape)
"aj" = (
/obj/effect/turf_decal/delivery,
/obj/structure/closet/crate/large,
/obj/effect/spawner/lootdrop/maintenance/eight,
/turf/open/floor/plasteel,
/area/shuttle/escape/luxury)
"ak" = (
/turf/open/floor/plasteel,
/area/shuttle/escape/luxury)
"al" = (
/turf/closed/wall/mineral/plastitanium/nodiagonal,
/area/shuttle/escape/luxury)
"ap" = (
/obj/machinery/stasis,
/obj/effect/turf_decal/bot,
/obj/effect/turf_decal/tile/blue{
	dir = 1
	},
/obj/effect/turf_decal/tile/blue{
	dir = 4
	},
/turf/open/floor/plasteel/white,
/area/shuttle/escape)
"aq" = (
/obj/effect/turf_decal/delivery,
/obj/structure/reagent_dispensers/fueltank,
/obj/structure/window{
	dir = 4
	},
/turf/open/floor/plasteel,
/area/shuttle/escape/luxury)
"ar" = (
/obj/structure/shuttle/engine/propulsion{
	dir = 8
	},
/turf/open/floor/plating/airless,
/area/shuttle/escape/luxury)
"as" = (
/obj/structure/shuttle/engine/heater{
	dir = 8
	},
/obj/structure/window/reinforced{
	dir = 4
	},
/turf/open/floor/plating/airless,
/area/shuttle/escape/luxury)
"at" = (
/turf/open/floor/mineral/plastitanium/red/brig,
/area/shuttle/escape/brig)
"av" = (
/obj/machinery/door/poddoor/shutters/indestructible{
	id = "ohnopoors"
	},
/turf/closed/indestructible/opsglass{
	desc = "A durable looking window made of an alloy of of plasma and titanium.";
	name = "plastitanium window"
	},
/area/shuttle/escape/luxury)
"aw" = (
/obj/effect/turf_decal/stripes{
	dir = 8
	},
/turf/open/floor/plasteel/monofloor/white,
/area/shuttle/escape/luxury)
"ax" = (
/obj/effect/decal/cleanable/cobweb/cobweb2,
/obj/machinery/light/small{
	dir = 4
	},
/obj/effect/turf_decal/dust,
/turf/open/floor/plasteel,
/area/shuttle/escape/luxury)
"ay" = (
/turf/closed/indestructible/syndicate,
/area/shuttle/escape/luxury)
"az" = (
/obj/machinery/stasis,
/obj/effect/turf_decal/bot,
/obj/effect/turf_decal/tile/blue{
	dir = 1
	},
/obj/effect/turf_decal/tile/blue{
	dir = 4
	},
/turf/open/floor/plasteel/white,
/area/shuttle/escape/luxury)
"aA" = (
/obj/machinery/button/door{
	id = "ohnopoors";
	name = "window shutters";
	pixel_x = -5;
	pixel_y = 26
	},
/turf/open/floor/wood,
/area/shuttle/escape/luxury)
"aC" = (
/obj/structure/table/wood/fancy/red,
/obj/item/food/fuegoburrito,
/turf/open/floor/carpet/red,
/area/shuttle/escape/luxury)
"aD" = (
/obj/structure/table/wood/fancy/red,
/obj/item/food/pizza/sassysage,
/obj/item/food/honeybun{
	pixel_x = 3;
	pixel_y = 8
	},
/turf/open/floor/carpet/red,
/area/shuttle/escape/luxury)
"aE" = (
/obj/structure/table/wood/fancy/red,
/obj/item/food/burger/baconburger,
/obj/item/food/honeybun{
	pixel_x = 3;
	pixel_y = 13
	},
/turf/open/floor/carpet/red,
/area/shuttle/escape/luxury)
"aF" = (
/obj/structure/table/wood/fancy/red,
/obj/item/food/roastparsnip{
	pixel_x = 3;
	pixel_y = 4
	},
/turf/open/floor/carpet/red,
/area/shuttle/escape/luxury)
"aG" = (
/obj/structure/table/wood/fancy/red,
/obj/item/food/bearsteak,
/obj/item/food/honeybun{
	pixel_x = 3;
	pixel_y = 3
	},
/turf/open/floor/carpet/red,
/area/shuttle/escape/luxury)
"aH" = (
/obj/structure/table/wood/fancy/red,
/obj/item/food/benedict,
/turf/open/floor/carpet/red,
/area/shuttle/escape/luxury)
"aI" = (
/obj/structure/table/wood/fancy/red,
/obj/item/food/salad/jungle{
	pixel_y = 4
	},
/turf/open/floor/carpet/red,
/area/shuttle/escape/luxury)
"aJ" = (
/obj/structure/table/wood/fancy/red,
/obj/item/food/grilled_cheese_sandwich,
/turf/open/floor/carpet/red,
/area/shuttle/escape/luxury)
"aK" = (
/obj/structure/table/wood/fancy/red,
/obj/item/food/salad/gumbo{
	pixel_y = 5
	},
/turf/open/floor/carpet/red,
/area/shuttle/escape/luxury)
"aL" = (
/obj/structure/table/wood/fancy/red,
/obj/item/food/soup/meatball{
	pixel_y = 6
	},
/turf/open/floor/carpet/red,
/area/shuttle/escape/luxury)
"aM" = (
/turf/open/floor/plasteel/monofloor/white,
/area/shuttle/escape/luxury)
"aN" = (
/obj/structure/table/wood/fancy/red,
/obj/item/food/salad/validsalad,
/obj/item/food/honeybun{
	pixel_x = 3;
	pixel_y = 6
	},
/turf/open/floor/carpet/red,
/area/shuttle/escape/luxury)
"aO" = (
/obj/structure/table/wood/fancy/red,
/obj/item/food/salad/edensalad,
/turf/open/floor/carpet/red,
/area/shuttle/escape/luxury)
"aP" = (
/obj/structure/table/wood/fancy/red,
/obj/item/food/soup/milo,
/obj/item/food/honeybun{
	pixel_x = 3;
	pixel_y = 4
	},
/turf/open/floor/carpet/red,
/area/shuttle/escape/luxury)
"aQ" = (
/obj/structure/table/wood/fancy/red,
/obj/item/food/burger/baconburger,
/turf/open/floor/carpet/red,
/area/shuttle/escape/luxury)
"aS" = (
/obj/item/kirbyplants{
	icon_state = "plant-21"
	},
/turf/open/floor/wood,
/area/shuttle/escape/luxury)
"aT" = (
/obj/structure/table/wood/fancy/red,
/obj/item/food/cheese_sandwich,
/turf/open/floor/carpet/red,
/area/shuttle/escape/luxury)
"aU" = (
/obj/structure/table/wood/fancy/red,
/obj/item/food/burger/rib,
/turf/open/floor/carpet/red,
/area/shuttle/escape/luxury)
"aV" = (
/obj/structure/table/wood/fancy/red,
/obj/item/food/nachos,
/turf/open/floor/carpet/red,
/area/shuttle/escape/luxury)
"aW" = (
/obj/structure/table/wood/fancy/red,
/obj/item/food/salad/aesirsalad,
/turf/open/floor/carpet/red,
/area/shuttle/escape/luxury)
"aX" = (
/obj/structure/table/wood/fancy/red,
/obj/item/food/cake/chocolate,
/turf/open/floor/carpet/red,
/area/shuttle/escape/luxury)
"aY" = (
/obj/structure/table/wood/fancy/red,
/obj/item/food/cornedbeef,
/turf/open/floor/carpet/red,
/area/shuttle/escape/luxury)
"aZ" = (
/obj/structure/table/wood/fancy/red,
/obj/item/food/kebab/monkey,
/turf/open/floor/carpet/red,
/area/shuttle/escape/luxury)
"ba" = (
/obj/structure/table/wood/fancy/red,
/obj/item/food/spaghetti/beefnoodle,
/obj/item/food/honeybun{
	pixel_x = 3;
	pixel_y = 5
	},
/turf/open/floor/carpet/red,
/area/shuttle/escape/luxury)
"bc" = (
/obj/effect/turf_decal/dust,
/turf/open/floor/plasteel,
/area/shuttle/escape/luxury)
"bd" = (
/obj/structure/chair/comfy/black,
/obj/machinery/light{
	dir = 1
	},
/turf/open/floor/carpet/red,
/area/shuttle/escape/luxury)
"be" = (
/obj/structure/girder,
/turf/open/floor/plasteel,
/area/shuttle/escape/luxury)
"bf" = (
/obj/structure/closet/crate/trashcart,
/obj/effect/turf_decal/loading_area,
/obj/effect/spawner/lootdrop/maintenance/six,
/turf/open/floor/plasteel,
/area/shuttle/escape/luxury)
"bg" = (
/obj/structure/closet/crate/trashcart,
/obj/effect/turf_decal/loading_area,
/obj/effect/spawner/lootdrop/maintenance/three,
/turf/open/floor/plasteel,
/area/shuttle/escape/luxury)
"bi" = (
/obj/machinery/vending/wallmed{
	name = "Emergency NanoMed";
	pixel_x = 26;
	use_power = 0
	},
/turf/open/floor/plasteel/monofloor/white,
/area/shuttle/escape/luxury)
"bj" = (
/obj/structure/chair/comfy/shuttle,
/obj/machinery/light{
	dir = 1
	},
/turf/open/floor/mineral/plastitanium/red/brig,
/area/shuttle/escape/brig)
"bk" = (
/obj/machinery/light{
	dir = 1
	},
/turf/open/floor/carpet/royalblue,
/area/shuttle/escape/luxury)
"bl" = (
/obj/structure/table,
/obj/item/scalpel{
	pixel_y = 12
	},
/obj/item/circular_saw,
/obj/item/retractor{
	pixel_x = 4
	},
/obj/item/hemostat{
	pixel_x = -4
	},
/obj/item/clothing/gloves/color/latex,
/obj/item/clothing/mask/surgical,
/obj/item/surgicaldrill,
/obj/item/cautery,
/obj/effect/turf_decal/bot,
/obj/effect/turf_decal/tile/blue,
/obj/effect/turf_decal/tile/blue{
	dir = 8
	},
/turf/open/floor/plasteel/white,
/area/shuttle/escape/luxury)
"bm" = (
/obj/machinery/iv_drip,
/mob/living/simple_animal/bot/medbot{
	name = "\improper emergency medibot";
	pixel_x = -3;
	pixel_y = 2
	},
/obj/effect/turf_decal/stripes{
	dir = 8
	},
/obj/effect/turf_decal/tile/blue{
	dir = 4
	},
/turf/open/floor/plasteel/white,
/area/shuttle/escape)
"bn" = (
/obj/effect/turf_decal/delivery,
/obj/structure/closet/crate/engineering/electrical,
/obj/effect/decal/cleanable/robot_debris,
/obj/effect/spawner/lootdrop/maintenance/eight,
/turf/open/floor/plasteel,
/area/shuttle/escape/luxury)
"bo" = (
/obj/effect/turf_decal/delivery,
/obj/structure/closet/crate/engineering,
/obj/effect/spawner/lootdrop/maintenance/eight,
/turf/open/floor/plasteel,
/area/shuttle/escape/luxury)
"bp" = (
/obj/effect/turf_decal/delivery,
/obj/structure/window{
	dir = 4
	},
/obj/structure/closet/crate{
	icon_state = "crateopen"
	},
/turf/open/floor/plasteel,
/area/shuttle/escape/luxury)
"bq" = (
/obj/item/stack/rods/ten,
/turf/open/floor/plating,
/area/shuttle/escape/luxury)
"br" = (
/obj/effect/decal/cleanable/robot_debris,
/obj/effect/turf_decal/dust,
/turf/open/floor/plating,
/area/shuttle/escape/luxury)
"bs" = (
/turf/open/floor/plating,
/area/shuttle/escape/luxury)
"bt" = (
/obj/structure/window/reinforced{
	dir = 1;
	pixel_y = 2
	},
/obj/structure/table/wood/fancy/black,
/obj/machinery/chem_dispenser/drinks,
/turf/open/floor/carpet/black,
/area/shuttle/escape/luxury)
"bu" = (
/obj/structure/window/reinforced{
	dir = 1;
	pixel_y = 2
	},
/obj/structure/table/wood/fancy/black,
/obj/machinery/chem_dispenser/drinks/beer,
/turf/open/floor/carpet/black,
/area/shuttle/escape/luxury)
"bv" = (
/obj/structure/window/reinforced{
	dir = 1;
	pixel_y = 2
	},
/obj/structure/table/wood/fancy/black,
/obj/item/storage/box/drinkingglasses,
/turf/open/floor/carpet/black,
/area/shuttle/escape/luxury)
"bw" = (
/obj/structure/window/reinforced{
	dir = 1;
	pixel_y = 2
	},
/obj/machinery/vending/boozeomat/all_access,
/turf/open/floor/carpet/black,
/area/shuttle/escape/luxury)
"bx" = (
/obj/machinery/door/airlock/public/glass{
	name = "Emergency Shuttle Infirmary"
	},
/obj/effect/turf_decal/stripes{
	dir = 4
	},
/obj/effect/turf_decal/stripes{
	dir = 8
	},
/turf/open/floor/plasteel/monofloor/white,
/area/shuttle/escape/luxury)
"by" = (
/obj/structure/closet/crate/large,
/obj/effect/turf_decal/delivery,
/obj/effect/decal/cleanable/robot_debris,
/obj/effect/spawner/lootdrop/maintenance/eight,
/turf/open/floor/plasteel,
/area/shuttle/escape/luxury)
"bz" = (
/obj/effect/turf_decal/delivery,
/obj/structure/closet/crate{
	icon_state = "crateopen"
	},
/turf/open/floor/plasteel,
/area/shuttle/escape/luxury)
"bA" = (
/obj/effect/turf_decal/delivery,
/obj/structure/window{
	dir = 4
	},
/obj/structure/closet/crate{
	icon_state = "crateopen"
	},
/obj/effect/decal/cleanable/oil,
/obj/effect/spawner/lootdrop/maintenance/two,
/turf/open/floor/plasteel,
/area/shuttle/escape/luxury)
"bB" = (
/obj/item/stack/ore/glass,
/obj/effect/turf_decal/dust,
/turf/open/floor/plating,
/area/shuttle/escape/luxury)
"bC" = (
/obj/structure/chair/comfy/shuttle{
	dir = 1
	},
/obj/effect/turf_decal/stripes/line,
/obj/structure/window,
/turf/open/floor/plasteel,
/area/shuttle/escape/luxury)
"bD" = (
/obj/structure/chair/comfy/shuttle{
	dir = 1
	},
/turf/open/floor/mineral/plastitanium/red/brig,
/area/shuttle/escape/brig)
"bE" = (
/obj/machinery/stasis,
/obj/machinery/light{
	dir = 1
	},
/obj/effect/turf_decal/bot,
/obj/effect/turf_decal/tile/blue{
	dir = 1
	},
/obj/effect/turf_decal/tile/blue{
	dir = 4
	},
/turf/open/floor/plasteel/white,
/area/shuttle/escape)
"bH" = (
/obj/structure/door_assembly,
/turf/open/floor/plating,
/area/shuttle/escape/luxury)
"bI" = (
/obj/item/stack/tile/plasteel,
/obj/effect/turf_decal/dust,
/turf/open/floor/plasteel,
/area/shuttle/escape/luxury)
"bJ" = (
/obj/structure/chair/comfy/shuttle,
/obj/effect/turf_decal/stripes/line{
	dir = 1
	},
/obj/structure/window{
	dir = 1
	},
/turf/open/floor/plasteel,
/area/shuttle/escape/luxury)
"bK" = (
/obj/structure/chair/comfy/shuttle,
/obj/effect/turf_decal/stripes/line{
	dir = 1
	},
/obj/structure/window{
	dir = 1
	},
/turf/open/floor/plating,
/area/shuttle/escape/luxury)
"bL" = (
/obj/structure/window/reinforced,
/obj/structure/table/wood/fancy/green,
/obj/item/instrument/violin,
/obj/item/instrument/saxophone,
/obj/item/instrument/trumpet,
/turf/open/floor/carpet/black,
/area/shuttle/escape/luxury)
"bM" = (
/obj/structure/window/reinforced,
/turf/open/floor/carpet/black,
/area/shuttle/escape/luxury)
"bN" = (
/obj/machinery/light{
	dir = 4
	},
/turf/open/floor/carpet/royalblue,
/area/shuttle/escape/luxury)
"bO" = (
/obj/structure/chair/comfy/shuttle{
	dir = 1
	},
/obj/effect/turf_decal/stripes/line,
/obj/structure/window,
/obj/effect/turf_decal/dust,
/turf/open/floor/plasteel,
/area/shuttle/escape/luxury)
"bP" = (
/obj/structure/closet/crate/freezer,
/obj/item/reagent_containers/blood,
/obj/item/reagent_containers/blood,
/obj/item/reagent_containers/blood/a_minus,
/obj/item/reagent_containers/blood/b_minus{
	pixel_x = -4;
	pixel_y = 4
	},
/obj/item/reagent_containers/blood/b_plus{
	pixel_x = 1;
	pixel_y = 2
	},
/obj/item/reagent_containers/blood/o_minus,
/obj/item/reagent_containers/blood/o_plus{
	pixel_x = -2;
	pixel_y = -1
	},
/obj/item/reagent_containers/blood/random,
/obj/item/reagent_containers/blood/random,
/obj/item/reagent_containers/blood/a_plus,
/obj/item/reagent_containers/blood/random,
/obj/effect/turf_decal/stripes{
	dir = 8
	},
/obj/effect/turf_decal/tile/blue,
/turf/open/floor/plasteel/white,
/area/shuttle/escape/luxury)
"bQ" = (
/turf/open/floor/carpet/black,
/area/shuttle/escape/luxury)
"bR" = (
/obj/effect/decal/cleanable/glass,
/obj/effect/turf_decal/dust,
/turf/open/floor/plating,
/area/shuttle/escape/luxury)
"bS" = (
/obj/item/stack/tile/plasteel,
/turf/open/floor/plating,
/area/shuttle/escape/luxury)
"bT" = (
/obj/effect/decal/cleanable/oil,
/turf/open/floor/plasteel,
/area/shuttle/escape/luxury)
"bU" = (
/obj/effect/decal/cleanable/generic,
/turf/open/floor/plasteel,
/area/shuttle/escape/luxury)
"bX" = (
/obj/structure/chair/comfy/shuttle{
	dir = 1
	},
/obj/effect/turf_decal/stripes/line,
/obj/structure/window,
/obj/effect/turf_decal/dust,
/turf/open/floor/plating,
/area/shuttle/escape/luxury)
"bZ" = (
/obj/machinery/door/airlock/command/glass{
	name = "Cockpit";
	req_access_txt = "19"
	},
/obj/effect/turf_decal/stripes/line{
	dir = 4
	},
/obj/effect/turf_decal/stripes/line{
	dir = 8
	},
/turf/open/floor/plasteel/white,
/area/shuttle/escape/luxury)
"cb" = (
/obj/structure/chair/comfy/brown{
	dir = 4
	},
/turf/open/floor/carpet/executive,
/area/shuttle/escape/luxury)
"cc" = (
/obj/effect/turf_decal/delivery,
/obj/structure/closet/crate/large,
/obj/effect/decal/cleanable/robot_debris,
/obj/effect/spawner/lootdrop/maintenance/eight,
/turf/open/floor/plasteel,
/area/shuttle/escape/luxury)
"cd" = (
/turf/open/floor/mineral/silver,
/area/shuttle/escape/luxury)
"ce" = (
/obj/machinery/computer/communications{
	dir = 8
	},
/turf/open/floor/mineral/diamond,
/area/shuttle/escape/luxury)
"cf" = (
/obj/effect/decal/cleanable/vomit/old,
/obj/item/stack/ore/glass,
/obj/effect/turf_decal/dust,
/turf/open/floor/plasteel,
/area/shuttle/escape/luxury)
"cg" = (
/obj/effect/decal/cleanable/glass,
/turf/open/floor/plasteel,
/area/shuttle/escape/luxury)
"ch" = (
/obj/structure/chair/comfy/black{
	dir = 1
	},
/turf/open/floor/carpet/red,
/area/shuttle/escape/luxury)
"ci" = (
/turf/open/floor/carpet/royalblue,
/area/shuttle/escape/luxury)
"cj" = (
/turf/open/floor/mineral/gold,
/area/shuttle/escape/luxury)
"ck" = (
/obj/item/stack/tile/plasteel,
/obj/machinery/light/small{
	dir = 8
	},
/turf/open/floor/plasteel,
/area/shuttle/escape/luxury)
"cl" = (
/obj/structure/chair/comfy/brown{
	dir = 4
	},
/turf/open/floor/mineral/gold,
/area/shuttle/escape/luxury)
"cm" = (
/obj/machinery/computer/med_data{
	dir = 8
	},
/turf/open/floor/mineral/gold,
/area/shuttle/escape/luxury)
"cn" = (
/obj/machinery/door/airlock{
	name = "Economy Medical"
	},
/obj/effect/turf_decal/dust,
/turf/open/floor/plasteel,
/area/shuttle/escape/luxury)
"co" = (
/obj/item/shard,
/obj/effect/turf_decal/dust,
/turf/open/floor/plating,
/area/shuttle/escape/luxury)
"cp" = (
/obj/structure/closet/crate/freezer,
/obj/effect/decal/cleanable/blood/old,
/obj/item/bot_assembly/medbot,
/obj/item/stack/medical/gauze,
/obj/item/reagent_containers/food/drinks/bottle/whiskey,
/obj/item/reagent_containers/glass/bottle/ethanol,
/obj/item/organ/stomach,
/obj/item/clothing/mask/surgical,
/turf/open/floor/plasteel,
/area/shuttle/escape/luxury)
"cq" = (
/obj/effect/decal/cleanable/chem_pile,
/obj/effect/turf_decal/dust,
/turf/open/floor/plating,
/area/shuttle/escape/luxury)
"cr" = (
/obj/structure/frame/machine,
/obj/effect/decal/cleanable/cobweb/cobweb2,
/obj/effect/turf_decal/dust,
/turf/open/floor/plasteel,
/area/shuttle/escape/luxury)
"cs" = (
/obj/effect/decal/cleanable/robot_debris,
/obj/effect/turf_decal/dust,
/turf/open/floor/plasteel,
/area/shuttle/escape/luxury)
"ct" = (
/obj/machinery/door/airlock/silver{
	name = "Restroom"
	},
/turf/open/floor/plasteel/monofloor/white,
/area/shuttle/escape/luxury)
"cu" = (
/obj/structure/sink{
	pixel_y = 13
	},
/obj/structure/mirror{
	pixel_y = 30
	},
/turf/open/floor/plasteel/freezer,
/area/shuttle/escape/luxury)
"cv" = (
/obj/structure/table,
/obj/item/reagent_containers/pill/maintenance{
	pixel_x = -6;
	pixel_y = -3
	},
/obj/item/reagent_containers/pill/maintenance{
	pixel_x = 8;
	pixel_y = -3
	},
/obj/item/reagent_containers/pill/maintenance,
/obj/item/healthanalyzer{
	pixel_y = 9
	},
/obj/effect/turf_decal/dust,
/turf/open/floor/plating,
/area/shuttle/escape/luxury)
"cw" = (
/obj/structure/bed,
/obj/effect/turf_decal/dust,
/turf/open/floor/plasteel,
/area/shuttle/escape/luxury)
"cx" = (
/obj/effect/decal/cleanable/vomit/old,
/obj/effect/turf_decal/dust,
/turf/open/floor/plasteel,
/area/shuttle/escape/luxury)
"cy" = (
/obj/item/shard,
/obj/effect/turf_decal/dust,
/turf/open/floor/plasteel,
/area/shuttle/escape/luxury)
"cz" = (
/obj/structure/table,
/obj/item/storage/firstaid/advanced,
/obj/item/storage/firstaid/regular,
/obj/item/storage/firstaid/fire,
/obj/item/reagent_containers/glass/bottle/epinephrine{
	pixel_x = 6
	},
/obj/item/reagent_containers/glass/bottle/multiver{
	pixel_x = -3
	},
/obj/item/reagent_containers/glass/bottle/epinephrine{
	pixel_x = -3;
	pixel_y = 8
	},
/obj/item/reagent_containers/glass/bottle/multiver{
	pixel_x = 6;
	pixel_y = 8
	},
/obj/item/reagent_containers/syringe/epinephrine{
	pixel_x = 3;
	pixel_y = -2
	},
/obj/item/reagent_containers/syringe/epinephrine{
	pixel_x = 3;
	pixel_y = -2
	},
/obj/item/reagent_containers/syringe/epinephrine{
	pixel_x = 3;
	pixel_y = -2
	},
/obj/machinery/light,
/obj/effect/turf_decal/bot,
/obj/effect/turf_decal/tile/blue,
/obj/effect/turf_decal/tile/blue{
	dir = 8
	},
/obj/item/defibrillator/compact/loaded,
/turf/open/floor/plasteel/white,
/area/shuttle/escape/luxury)
"cA" = (
/obj/effect/decal/cleanable/oil,
/obj/effect/turf_decal/dust,
/turf/open/floor/plating,
/area/shuttle/escape/luxury)
"cB" = (
/obj/structure/bed,
/obj/effect/decal/cleanable/blood/old,
/turf/open/floor/plasteel,
/area/shuttle/escape/luxury)
"cC" = (
/obj/structure/grille/broken,
/obj/effect/spawner/lootdrop/maintenance/two,
/turf/open/floor/plasteel,
/area/shuttle/escape/luxury)
"cD" = (
/obj/structure/frame/machine,
/obj/effect/turf_decal/delivery,
/obj/effect/decal/cleanable/cobweb,
/obj/machinery/light/small{
	dir = 8
	},
/turf/open/floor/plasteel,
/area/shuttle/escape/luxury)
"cE" = (
/obj/structure/chair/comfy/black,
/turf/open/floor/carpet/red,
/area/shuttle/escape/luxury)
"cG" = (
/turf/open/floor/carpet/executive,
/area/shuttle/escape/luxury)
"cH" = (
/obj/machinery/light,
/turf/open/floor/mineral/gold,
/area/shuttle/escape/luxury)
"cI" = (
/turf/open/floor/wood,
/area/shuttle/escape/luxury)
"cJ" = (
/obj/item/stack/tile/plasteel,
/obj/machinery/light/small{
	dir = 8
	},
/obj/effect/turf_decal/dust,
/turf/open/floor/plating,
/area/shuttle/escape/luxury)
"cK" = (
/obj/structure/table,
/obj/item/wirecutters{
	pixel_y = 6
	},
/obj/item/hatchet,
/obj/item/kitchen/knife,
/obj/machinery/light/small{
	dir = 8
	},
/turf/open/floor/plating,
/area/shuttle/escape/luxury)
"cL" = (
/obj/structure/chair/comfy/black{
	dir = 1
	},
/obj/machinery/light,
/turf/open/floor/carpet/red,
/area/shuttle/escape/luxury)
"cM" = (
/turf/open/floor/plasteel/freezer,
/area/shuttle/escape/luxury)
"cN" = (
/obj/effect/spawner/structure/window/shuttle,
/turf/open/floor/plating,
/area/shuttle/escape/luxury)
"hl" = (
/obj/structure/table/wood/fancy/blue,
/obj/item/storage/fancy/cigarettes/cigars/havana{
	pixel_y = 7
	},
/obj/item/lighter,
/turf/open/floor/mineral/gold,
/area/shuttle/escape/luxury)
"kY" = (
/obj/structure/table/wood/fancy/blue,
/obj/machinery/recharger,
/turf/open/floor/mineral/gold,
/area/shuttle/escape/luxury)
"qa" = (
/obj/structure/toilet{
	pixel_y = 8
	},
/obj/machinery/light{
	dir = 4
	},
/turf/open/floor/plasteel/monofloor/white,
/area/shuttle/escape/luxury)
"ve" = (
/obj/effect/turf_decal/dust,
/turf/open/floor/plating,
/area/shuttle/escape/luxury)
"Eb" = (
/obj/machinery/door/airlock/security/glass{
	name = "Escape Shuttle Cell";
	req_access_txt = "2"
	},
/obj/structure/fans/tiny,
/turf/open/floor/mineral/plastitanium/red/brig,
/area/shuttle/escape/luxury)
"Fc" = (
/obj/machinery/computer/emergency_shuttle{
	dir = 8
	},
/turf/open/floor/mineral/diamond,
/area/shuttle/escape/luxury)
"Fg" = (
/obj/effect/decal/cleanable/generic,
/obj/effect/turf_decal/dust,
/turf/open/floor/plasteel,
/area/shuttle/escape/luxury)
"Go" = (
/obj/machinery/light,
/turf/open/floor/plasteel/freezer,
/area/shuttle/escape/luxury)
"GS" = (
/obj/structure/table/wood/fancy/red,
/obj/item/food/salad/citrusdelight{
	pixel_x = 1;
	pixel_y = 3
	},
/turf/open/floor/carpet/red,
/area/shuttle/escape/luxury)
"Ij" = (
/obj/machinery/computer/secure_data{
	dir = 8
	},
/turf/open/floor/mineral/gold,
/area/shuttle/escape/luxury)
"Lk" = (
/obj/structure/table/wood/fancy/red,
/obj/item/food/enchiladas{
	pixel_y = 3
	},
/turf/open/floor/carpet/red,
/area/shuttle/escape/luxury)
"Lt" = (
/obj/machinery/door/airlock/security/glass{
	name = "Escape Shuttle Cell";
	req_access_txt = "2"
	},
/obj/machinery/scanner_gate/luxury_shuttle,
/turf/open/floor/mineral/plastitanium/red/brig,
/area/shuttle/escape/brig)
"Mv" = (
/obj/structure/window/reinforced,
/obj/structure/table/wood/fancy/green,
/obj/item/reagent_containers/food/drinks/trophy/gold_cup,
/turf/open/floor/carpet/black,
/area/shuttle/escape/luxury)
"Mx" = (
/obj/item/stack/tile/plasteel,
/obj/effect/turf_decal/dust,
/turf/open/floor/plating,
/area/shuttle/escape/luxury)
"OH" = (
/turf/closed/indestructible/opsglass{
	desc = "A durable looking window made of an alloy of of plasma and titanium.";
	name = "plastitanium window"
	},
/area/shuttle/escape/luxury)
"Pk" = (
/obj/structure/table/optable,
/obj/item/surgical_drapes,
/obj/effect/turf_decal/bot,
/obj/effect/turf_decal/tile/blue,
/obj/effect/turf_decal/tile/blue{
	dir = 8
	},
/turf/open/floor/plasteel/white,
/area/shuttle/escape/luxury)
"PP" = (
/obj/machinery/light{
	dir = 8
	},
/turf/open/floor/wood,
/area/shuttle/escape/luxury)
"SU" = (
/obj/structure/chair/comfy/shuttle,
/obj/effect/turf_decal/stripes/line{
	dir = 1
	},
/obj/structure/window{
	dir = 1
	},
/obj/effect/turf_decal/dust,
/turf/open/floor/plasteel,
/area/shuttle/escape/luxury)
"WL" = (
/obj/machinery/light{
	dir = 1
	},
/turf/open/floor/mineral/gold,
/area/shuttle/escape/luxury)

(1,1,1) = {"
aa
al
ar
ar
al
ar
ar
ar
ar
al
ar
ar
al
aa
"}
(2,1,1) = {"
ab
al
as
as
al
as
as
as
as
al
as
as
al
ab
"}
(3,1,1) = {"
ab
ah
bn
by
ab
cD
aj
cc
aj
ab
cp
cv
cK
ab
"}
(4,1,1) = {"
ab
aj
bo
bz
bH
bR
bC
bJ
bc
cn
cq
ve
cA
ab
"}
(5,1,1) = {"
ab
aq
bp
bA
ab
bS
bC
SU
cf
ab
cr
cw
cB
ab
"}
(6,1,1) = {"
ab
be
bq
bB
ck
bT
ak
bU
cg
ab
ab
ab
ab
ab
"}
(7,1,1) = {"
ab
bf
br
bO
bJ
bI
bO
bK
ve
co
cs
cJ
cC
ab
"}
(8,1,1) = {"
ab
bg
bc
bC
bJ
Fg
bO
bJ
Mx
bO
SU
cx
bC
ab
"}
(9,1,1) = {"
ac
ax
bs
bC
bK
Mx
bX
SU
bc
bC
bJ
cy
bC
ab
"}
(10,1,1) = {"
ag
ag
af
ag
ag
ay
av
av
av
ay
av
av
av
ay
"}
(11,1,1) = {"
Eb
at
at
bD
ag
aA
cI
cI
cI
PP
cI
cI
cI
ag
"}
(12,1,1) = {"
ag
bj
at
bD
ag
cE
aG
aK
ch
cE
aO
aT
cL
ag
"}
(13,1,1) = {"
ag
at
at
bD
ag
cE
aH
aL
ch
cE
aP
aU
ch
ag
"}
(14,1,1) = {"
ag
Lt
ag
ag
ag
bd
aC
aE
ch
cE
aX
aZ
ch
ag
"}
(15,1,1) = {"
ag
ci
bt
bQ
bL
cE
aD
aF
ch
cE
aY
ba
ch
ag
"}
(16,1,1) = {"
ag
ci
bu
bQ
Mv
cE
aI
GS
ch
cE
Lk
aV
ch
ag
"}
(17,1,1) = {"
ae
ci
bw
bQ
bM
cE
aJ
aN
ch
cE
aQ
aW
cL
ag
"}
(18,1,1) = {"
ag
bk
bv
bQ
bM
cI
cI
cI
cI
cI
cI
cI
cI
ag
"}
(19,1,1) = {"
ad
ci
ci
ci
bN
ci
ci
ci
ci
bN
ci
ci
ci
ag
"}
(20,1,1) = {"
ag
aS
ci
aS
ag
cN
bZ
bZ
cN
ag
aS
ci
aS
ag
"}
(21,1,1) = {"
ag
cN
bx
cN
ag
kY
cd
cd
hl
ag
ag
ct
ag
ag
"}
(22,1,1) = {"
ai
bm
aw
bP
ag
cj
cG
cG
cj
ag
cu
cM
cM
ag
"}
(23,1,1) = {"
ai
bE
aM
cz
ag
WL
cG
cG
cH
ag
cu
cM
Go
ag
"}
(24,1,1) = {"
ai
ap
aM
Pk
ag
cl
cb
cb
cl
ag
ag
ag
cM
ag
"}
(25,1,1) = {"
ag
az
bi
bl
ag
Ij
Fc
ce
cm
ag
qa
ct
cM
ag
"}
(26,1,1) = {"
ag
ag
ag
ag
ag
OH
OH
OH
OH
ag
ag
ag
ag
ag
"}
