//MAP CONVERTED BY dmm2tgm.py THIS HEADER COMMENT PREVENTS RECONVERSION, DO NOT REMOVE
"dy" = (
/obj/machinery/light,
/turf/open/floor/mineral/titanium,
/area/shuttle/escape)
"eN" = (
/obj/structure/chair/comfy/shuttle,
/obj/machinery/light{
	dir = 1
	},
/turf/open/floor/mineral/plastitanium/red/brig,
/area/shuttle/escape/brig)
"fu" = (
/obj/item/kirbyplants{
	icon_state = "plant-22"
	},
/turf/open/floor/mineral/titanium/blue,
/area/shuttle/escape)
"fx" = (
/obj/machinery/computer/communications{
	dir = 4
	},
/turf/open/floor/mineral/titanium/blue,
/area/shuttle/escape)
"hl" = (
/obj/structure/table,
/obj/machinery/light{
	dir = 1
	},
/turf/open/floor/mineral/plastitanium,
/area/shuttle/escape)
"hC" = (
/turf/open/floor/mineral/titanium/white,
/area/shuttle/escape)
"iC" = (
/obj/structure/chair/comfy/shuttle,
/turf/open/floor/mineral/plastitanium,
/area/shuttle/escape)
"iO" = (
/obj/machinery/door/airlock/public/glass,
/turf/open/floor/mineral/titanium/white,
/area/shuttle/escape)
"iR" = (
/obj/structure/shuttle/engine/propulsion/right{
	dir = 4
	},
/turf/open/floor/plating/airless,
/area/shuttle/escape)
"iY" = (
/obj/structure/table/glass,
/obj/item/defibrillator/loaded,
/turf/open/floor/mineral/titanium/white,
/area/shuttle/escape)
"jk" = (
/obj/structure/chair/comfy/shuttle{
	dir = 1
	},
/obj/machinery/light,
/turf/open/floor/mineral/plastitanium,
/area/shuttle/escape)
"kE" = (
/obj/structure/table,
/obj/item/cautery,
/obj/item/surgicaldrill,
/obj/item/circular_saw{
	pixel_y = 9
	},
/turf/open/floor/mineral/titanium/white,
/area/shuttle/escape)
"kF" = (
/obj/structure/chair/comfy/shuttle,
/turf/open/floor/mineral/plastitanium/red/brig,
/area/shuttle/escape/brig)
"ls" = (
/turf/template_noop,
/area/template_noop)
"lH" = (
/obj/machinery/door/airlock/titanium,
/turf/open/floor/mineral/titanium,
/area/shuttle/escape)
"lI" = (
/turf/closed/wall/mineral/titanium,
/area/shuttle/escape)
"mv" = (
/obj/machinery/door/airlock/command/glass{
	name = "bridge door";
	req_access_txt = "19"
	},
/turf/open/floor/mineral/titanium,
/area/shuttle/escape)
"mE" = (
/obj/structure/chair/comfy/shuttle{
	dir = 1
	},
/obj/structure/window/reinforced,
/turf/open/floor/mineral/plastitanium,
/area/shuttle/escape)
"oV" = (
/obj/structure/chair/comfy/shuttle{
	dir = 8
	},
/turf/open/floor/mineral/plastitanium,
/area/shuttle/escape)
"qm" = (
/turf/closed/wall/mineral/titanium/nodiagonal,
/area/shuttle/escape)
"tL" = (
/obj/structure/table,
/obj/item/food/chocolatebar,
/turf/open/floor/mineral/plastitanium,
/area/shuttle/escape)
"tW" = (
/obj/structure/table/optable,
/obj/item/surgical_drapes,
/turf/open/floor/mineral/titanium/white,
/area/shuttle/escape)
"vd" = (
/obj/machinery/door/airlock/titanium,
/obj/docking_port/mobile/emergency{
	dir = 8;
	dwidth = 6;
	height = 18;
	name = "Birdboat emergency escape shuttle";
	port_direction = 4;
	width = 14
	},
/obj/structure/fans/tiny,
/turf/open/floor/mineral/titanium,
/area/shuttle/escape)
"vJ" = (
/turf/open/floor/mineral/titanium,
/area/shuttle/escape)
"wl" = (
/obj/structure/table,
/turf/open/floor/mineral/plastitanium,
/area/shuttle/escape)
"xM" = (
/obj/machinery/door/airlock/command/glass{
	name = "bridge door";
	req_access_txt = "19"
	},
/turf/open/floor/mineral/titanium,
/area/shuttle/escape/brig)
"zG" = (
/obj/structure/chair/comfy/shuttle{
	dir = 4
	},
/turf/open/floor/mineral/plastitanium,
/area/shuttle/escape)
"AP" = (
/obj/effect/spawner/structure/window/shuttle,
/turf/open/floor/plating,
/area/shuttle/escape)
"BJ" = (
/obj/structure/extinguisher_cabinet{
	pixel_x = -27
	},
/turf/open/floor/mineral/titanium/white,
/area/shuttle/escape)
"EH" = (
/obj/structure/table,
/obj/machinery/recharger{
	active_power_usage = 0;
	idle_power_usage = 0;
	pixel_y = 4;
	use_power = 0
	},
/turf/open/floor/mineral/plastitanium/red/brig,
/area/shuttle/escape/brig)
"EY" = (
/obj/machinery/door/airlock/security/glass{
	name = "security airlock";
	req_access_txt = "63"
	},
/turf/open/floor/mineral/plastitanium/red/brig,
/area/shuttle/escape/brig)
"FD" = (
/obj/structure/chair/comfy/shuttle{
	dir = 1
	},
/turf/open/floor/mineral/plastitanium,
/area/shuttle/escape)
"Gq" = (
/obj/structure/shuttle/engine/propulsion/left{
	dir = 4
	},
/turf/open/floor/plating/airless,
/area/shuttle/escape)
"GX" = (
/obj/structure/table,
/obj/item/food/spaghetti/boiledspaghetti{
	name = "pasghetti";
	pixel_x = 4;
	pixel_y = 7
	},
/turf/open/floor/mineral/plastitanium,
/area/shuttle/escape)
"Hl" = (
/obj/structure/chair/comfy/shuttle,
/obj/structure/window/reinforced{
	dir = 1;
	pixel_y = 2
	},
/turf/open/floor/mineral/plastitanium,
/area/shuttle/escape)
"II" = (
/obj/structure/table/glass,
/obj/item/storage/firstaid/fire{
	pixel_x = 5;
	pixel_y = 5
	},
/obj/item/storage/firstaid/toxin,
/turf/open/floor/mineral/titanium/white,
/area/shuttle/escape)
"JY" = (
/turf/open/floor/mineral/plastitanium/red/brig,
/area/shuttle/escape/brig)
"Kq" = (
/obj/structure/shuttle/engine/propulsion{
	dir = 4
	},
/turf/open/floor/plating/airless,
/area/shuttle/escape)
"Lu" = (
/obj/machinery/stasis,
/turf/open/floor/mineral/titanium/white,
/area/shuttle/escape)
"LX" = (
/turf/open/floor/mineral/plastitanium,
/area/shuttle/escape)
"MJ" = (
/obj/machinery/light{
	dir = 4
	},
/turf/open/floor/mineral/titanium/white,
/area/shuttle/escape)
"Qk" = (
/turf/open/floor/mineral/titanium/blue,
/area/shuttle/escape)
"Rz" = (
/obj/machinery/door/airlock/titanium,
/obj/structure/fans/tiny,
/turf/open/floor/mineral/titanium,
/area/shuttle/escape)
"SB" = (
/obj/structure/extinguisher_cabinet{
	pixel_y = -32
	},
/turf/open/floor/mineral/titanium,
/area/shuttle/escape)
"TH" = (
/obj/machinery/light/small,
/turf/open/floor/mineral/titanium,
/area/shuttle/escape)
"UC" = (
/obj/item/kirbyplants{
	icon_state = "plant-21"
	},
/turf/open/floor/mineral/titanium,
/area/shuttle/escape)
"Wn" = (
/obj/structure/chair/comfy/shuttle{
	dir = 8
	},
/turf/open/floor/mineral/titanium,
/area/shuttle/escape)
"WE" = (
/obj/structure/table,
/obj/item/storage/box/handcuffs,
/turf/open/floor/mineral/plastitanium/red/brig,
/area/shuttle/escape/brig)
"Xa" = (
/obj/machinery/computer/emergency_shuttle,
/turf/open/floor/mineral/titanium/blue,
/area/shuttle/escape)
"Xt" = (
/obj/structure/table/glass,
/obj/item/storage/firstaid/brute{
	pixel_x = 5;
	pixel_y = 5
	},
/obj/item/storage/firstaid/brute,
/obj/machinery/light{
	dir = 4
	},
/turf/open/floor/mineral/titanium/white,
/area/shuttle/escape)
"YY" = (
/obj/machinery/vending/wallmed{
	name = "Emergency NanoMed";
	use_power = 0
	},
/turf/closed/wall/mineral/titanium/nodiagonal,
/area/shuttle/escape)
"ZF" = (
/obj/structure/chair/comfy/shuttle{
	dir = 1
	},
/obj/structure/window/reinforced,
/obj/machinery/light{
	dir = 4
	},
/turf/open/floor/mineral/plastitanium,
/area/shuttle/escape)
"ZQ" = (
/obj/structure/table,
/obj/item/scalpel,
/obj/item/retractor{
	pixel_y = 5
	},
/obj/item/hemostat,
/turf/open/floor/mineral/titanium/white,
/area/shuttle/escape)

(1,1,1) = {"
ls
ls
lI
lI
AP
lI
AP
AP
AP
AP
AP
lI
ls
ls
"}
(2,1,1) = {"
ls
lI
qm
fx
fu
AP
UC
oV
oV
oV
UC
qm
lI
ls
"}
(3,1,1) = {"
ls
lI
Xa
Wn
vJ
mv
vJ
vJ
vJ
vJ
vJ
FD
lI
ls
"}
(4,1,1) = {"
ls
AP
Qk
vJ
dy
lI
LX
LX
wl
vJ
vJ
FD
lI
ls
"}
(5,1,1) = {"
ls
AP
Qk
vJ
SB
lI
zG
zG
tL
vJ
vJ
FD
lI
ls
"}
(6,1,1) = {"
ls
lI
fu
vJ
fu
lI
hl
GX
wl
vJ
vJ
jk
qm
lI
"}
(7,1,1) = {"
ls
lI
lI
xM
AP
lI
vJ
vJ
vJ
vJ
vJ
vJ
UC
lI
"}
(8,1,1) = {"
ls
lI
kF
JY
JY
AP
UC
vJ
vJ
vJ
vJ
vJ
SB
lI
"}
(9,1,1) = {"
ls
lI
kF
JY
JY
EY
vJ
vJ
mE
Hl
vJ
vJ
iC
AP
"}
(10,1,1) = {"
ls
lI
eN
JY
JY
AP
vJ
vJ
mE
Hl
vJ
vJ
iC
AP
"}
(11,1,1) = {"
ls
lI
kF
JY
EH
lI
vJ
vJ
mE
Hl
vJ
vJ
iC
AP
"}
(12,1,1) = {"
ls
lI
kF
JY
WE
lI
vJ
vJ
ZF
Hl
vJ
vJ
UC
lI
"}
(13,1,1) = {"
lI
lI
lI
lI
lI
qm
vJ
vJ
YY
lI
iO
AP
lI
lI
"}
(14,1,1) = {"
lI
ZQ
tW
hC
hC
iO
vJ
vJ
iO
BJ
hC
hC
Lu
lI
"}
(15,1,1) = {"
lI
kE
hC
hC
hC
iO
vJ
vJ
iO
hC
hC
hC
hC
lI
"}
(16,1,1) = {"
lI
hC
MJ
hC
lI
lI
lH
lH
lI
lI
II
Xt
iY
lI
"}
(17,1,1) = {"
lI
lI
lI
lI
lI
lI
vJ
TH
lI
lI
lI
lI
lI
lI
"}
(18,1,1) = {"
lI
iR
Kq
Gq
lI
lI
Rz
vd
lI
lI
iR
Kq
Gq
lI
"}
