//MAP CONVERTED BY dmm2tgm.py THIS HEADER COMMENT PREVENTS RECONVERSION, DO NOT REMOVE
"a" = (
/obj/machinery/door/airlock/titanium{
	name = "Shuttle Airlock"
	},
/obj/structure/fans/tiny,
/turf/open/floor/mineral/titanium/blue,
/area/shuttle/pod_1)
"g" = (
/obj/machinery/door/airlock/titanium{
	name = "Shuttle Airlock"
	},
/obj/docking_port/mobile/pod{
	height = 6;
	id = "podunit";
	name = "Cпасательная капсула (юнит)";
	port_direction = 2;
	width = 4
	},
/obj/structure/fans/tiny,
/turf/open/floor/mineral/titanium/blue,
/area/shuttle/pod_1)
"l" = (
/obj/structure/chair/comfy/shuttle{
	dir = 8
	},
/obj/machinery/light/small{
	dir = 4
	},
/turf/open/floor/mineral/titanium/blue,
/area/shuttle/pod_1)
"r" = (
/obj/structure/window/shuttle,
/obj/structure/grille,
/turf/open/floor/plating,
/area/shuttle/pod_1)
"y" = (
/turf/closed/wall/mineral/titanium,
/area/shuttle/pod_1)
"B" = (
/obj/structure/shuttle/engine/propulsion/burst,
/turf/closed/wall/mineral/titanium,
/area/shuttle/pod_1)
"D" = (
/obj/machinery/status_display/evac{
	pixel_x = 32
	},
/obj/structure/chair/comfy/shuttle{
	dir = 8
	},
/turf/open/floor/mineral/titanium/blue,
/area/shuttle/pod_1)
"E" = (
/obj/structure/chair/comfy/shuttle{
	dir = 8
	},
/turf/open/floor/mineral/titanium/blue,
/area/shuttle/pod_1)
"H" = (
/obj/structure/chair/comfy/shuttle{
	dir = 4
	},
/obj/machinery/light/small{
	dir = 8
	},
/turf/open/floor/mineral/titanium/blue,
/area/shuttle/pod_1)
"J" = (
/obj/machinery/computer/shuttle_flight/unit_shuttle{
	dir = 4
	},
/turf/open/floor/mineral/titanium/blue,
/area/shuttle/pod_1)
"N" = (
/obj/machinery/status_display/evac{
	pixel_x = -32
	},
/obj/structure/chair/comfy/shuttle{
	dir = 4
	},
/turf/open/floor/mineral/titanium/blue,
/area/shuttle/pod_1)
"U" = (
/obj/structure/chair/comfy/shuttle{
	dir = 4
	},
/turf/open/floor/mineral/titanium/blue,
/area/shuttle/pod_1)

(1,1,1) = {"
y
y
y
r
y
B
"}
(2,1,1) = {"
r
J
N
U
H
g
"}
(3,1,1) = {"
r
l
D
E
E
a
"}
(4,1,1) = {"
y
y
y
r
y
B
"}
