//MAP CONVERTED BY dmm2tgm.py THIS HEADER COMMENT PREVENTS RECONVERSION, DO NOT REMOVE
"a" = (
/turf/template_noop,
/area/template_noop)
"b" = (
/turf/closed/wall/mineral/titanium,
/area/shuttle/transport)
"c" = (
/obj/effect/spawner/structure/window/shuttle,
/turf/open/floor/plating,
/area/shuttle/transport)
"d" = (
/obj/machinery/door/airlock/external,
/obj/structure/fans/tiny,
/turf/open/floor/pod/dark,
/area/shuttle/transport)
"e" = (
/obj/structure/shuttle/engine/propulsion/left{
	dir = 8
	},
/turf/open/floor/plating/airless,
/area/shuttle/transport)
"f" = (
/obj/structure/shuttle/engine/heater{
	dir = 8
	},
/obj/structure/window/reinforced,
/turf/open/floor/plating/airless,
/area/shuttle/transport)
"g" = (
/obj/structure/chair/comfy/shuttle,
/obj/effect/turf_decal/bot,
/turf/open/floor/mineral/plastitanium,
/area/shuttle/transport)
"h" = (
/obj/machinery/light{
	dir = 1
	},
/obj/machinery/computer/shuttle_flight/ferry/request,
/obj/effect/turf_decal/box,
/turf/open/floor/mineral/plastitanium,
/area/shuttle/transport)
"i" = (
/obj/effect/turf_decal/stripes/end{
	dir = 1
	},
/turf/open/floor/mineral/plastitanium,
/area/shuttle/transport)
"j" = (
/obj/structure/shuttle/engine/heater{
	dir = 8
	},
/obj/structure/window/reinforced{
	dir = 4
	},
/turf/open/floor/plating/airless,
/area/shuttle/transport)
"k" = (
/obj/machinery/light/small,
/turf/open/floor/mineral/titanium/yellow,
/area/shuttle/transport)
"l" = (
/obj/machinery/door/airlock/titanium,
/turf/open/floor/mineral/titanium/yellow,
/area/shuttle/transport)
"m" = (
/obj/effect/turf_decal/stripes/corner,
/obj/effect/turf_decal/stripes/corner{
	dir = 1
	},
/obj/effect/turf_decal/stripes/corner{
	dir = 8
	},
/obj/effect/turf_decal/stripes/corner{
	dir = 4
	},
/turf/open/floor/mineral/plastitanium,
/area/shuttle/transport)
"n" = (
/obj/machinery/door/airlock/titanium,
/obj/docking_port/mobile{
	dir = 8;
	dwidth = 2;
	height = 13;
	id = "ferry";
	name = "ferry shuttle";
	preferred_direction = 4;
	width = 5
	},
/obj/structure/fans/tiny,
/turf/open/floor/mineral/plastitanium,
/area/shuttle/transport)
"o" = (
/obj/structure/shuttle/engine/heater{
	dir = 8
	},
/obj/structure/window/reinforced{
	dir = 1;
	pixel_y = 1
	},
/turf/open/floor/plating/airless,
/area/shuttle/transport)
"p" = (
/obj/structure/chair/comfy/shuttle{
	dir = 1
	},
/obj/effect/turf_decal/bot,
/turf/open/floor/mineral/plastitanium,
/area/shuttle/transport)
"q" = (
/obj/machinery/light,
/obj/structure/table/reinforced,
/obj/item/storage/firstaid/regular{
	pixel_x = -3;
	pixel_y = 3
	},
/obj/item/storage/firstaid/o2,
/obj/effect/turf_decal/box,
/turf/open/floor/mineral/plastitanium,
/area/shuttle/transport)
"r" = (
/obj/machinery/door/airlock/external,
/obj/structure/fans/tiny,
/turf/open/floor/pod/light,
/area/shuttle/transport)
"t" = (
/obj/effect/turf_decal/stripes/line,
/obj/effect/turf_decal/stripes/line{
	dir = 1
	},
/turf/open/floor/mineral/plastitanium,
/area/shuttle/transport)
"u" = (
/obj/structure/sign/warning/securearea/ntsign,
/turf/closed/wall/mineral/titanium,
/area/shuttle/transport)
"v" = (
/obj/structure/rack,
/obj/item/radio,
/obj/item/radio{
	pixel_x = 7;
	pixel_y = 2
	},
/obj/item/radio{
	pixel_x = -7;
	pixel_y = 2
	},
/obj/effect/turf_decal/bot,
/obj/effect/turf_decal/box,
/turf/open/floor/mineral/plastitanium,
/area/shuttle/transport)
"C" = (
/obj/effect/turf_decal/stripes/end{
	dir = 8
	},
/turf/open/floor/mineral/plastitanium,
/area/shuttle/transport)
"D" = (
/obj/structure/table/reinforced,
/obj/item/crowbar/red,
/obj/item/crowbar/red{
	pixel_x = -2;
	pixel_y = 6
	},
/obj/effect/turf_decal/box,
/turf/open/floor/mineral/plastitanium,
/area/shuttle/transport)
"E" = (
/obj/effect/turf_decal/stripes/end,
/turf/open/floor/mineral/plastitanium,
/area/shuttle/transport)
"L" = (
/obj/effect/turf_decal/bot,
/turf/open/floor/mineral/titanium/yellow,
/area/shuttle/transport)
"Q" = (
/obj/effect/turf_decal/stripes/end{
	dir = 4
	},
/turf/open/floor/mineral/plastitanium,
/area/shuttle/transport)

(1,1,1) = {"
a
a
e
a
a
"}
(2,1,1) = {"
a
e
j
e
a
"}
(3,1,1) = {"
a
f
L
o
a
"}
(4,1,1) = {"
a
b
k
b
a
"}
(5,1,1) = {"
b
b
l
b
b
"}
(6,1,1) = {"
b
g
C
p
b
"}
(7,1,1) = {"
c
g
t
p
c
"}
(8,1,1) = {"
u
h
t
v
u
"}
(9,1,1) = {"
d
i
m
E
r
"}
(10,1,1) = {"
u
D
t
q
u
"}
(11,1,1) = {"
b
g
t
p
b
"}
(12,1,1) = {"
c
g
Q
p
c
"}
(13,1,1) = {"
b
c
n
c
b
"}
