//MAP CONVERTED BY dmm2tgm.py THIS HEADER COMMENT PREVENTS RECONVERSION, DO NOT REMOVE
"ae" = (
/obj/effect/turf_decal/is12{
	icon_state = "m4"
	},
/turf/open/floor/plating/is12/dirt,
/area/ctf/warfare)
"aP" = (
/obj/structure/deployable_barricade/sandbags{
	dir = 1
	},
/obj/structure/cannon{
	dir = 1
	},
/turf/open/floor/plating/is12/wwidirt,
/area/ctf/warfare)
"be" = (
/obj/item/flashlight/flare{
	pixel_x = -2;
	pixel_y = 3
	},
/turf/open/floor/plating/is12/rock,
/area/ctf/warfare)
"dz" = (
/obj/structure/deployable_barricade/sandbags,
/obj/structure/deployable_barricade/sandbags{
	dir = 8
	},
/turf/open/floor/plating/is12/dirt,
/area/ctf/warfare)
"eo" = (
/obj/structure/deployable_barricade/sandbags{
	dir = 8
	},
/turf/open/floor/plating/is12/dirt,
/area/ctf/warfare)
"eN" = (
/obj/effect/turf_decal/is12,
/turf/open/floor/plating/is12/dirt,
/area/ctf/warfare)
"fh" = (
/obj/effect/turf_decal/is12{
	icon_state = "l2"
	},
/turf/open/floor/plating/is12/rock,
/area/ctf/warfare)
"fy" = (
/obj/structure/fermenting_barrel/gunpowder,
/turf/open/floor/plating/is12/wood,
/area/ctf/warfare)
"fJ" = (
/obj/structure/deployable_barricade/sandbags{
	dir = 1
	},
/turf/open/floor/plating/is12/rock,
/area/ctf/warfare)
"gQ" = (
/obj/item/flashlight/flare,
/turf/open/floor/plating/is12/surface,
/area/ctf/warfare)
"gR" = (
/obj/effect/turf_decal/is12{
	icon_state = "l3"
	},
/turf/open/floor/plating/is12/rock,
/area/ctf/warfare)
"im" = (
/obj/item/flashlight/flare,
/turf/open/floor/plating/is12/wood,
/area/ctf/warfare)
"iQ" = (
/obj/effect/turf_decal/is12{
	icon_state = "dirtcornerleft"
	},
/turf/open/floor/plating/is12/wood,
/area/ctf/warfare)
"jh" = (
/obj/effect/turf_decal/is12{
	icon_state = "m3"
	},
/turf/open/floor/plating/is12/dirt,
/area/ctf/warfare)
"jV" = (
/turf/open/floor/plating/is12/wwidirt,
/area/ctf/warfare)
"ko" = (
/obj/structure/deployable_barricade/sandbags{
	dir = 4
	},
/turf/open/floor/plating/is12/trenchcenter,
/area/ctf/warfare)
"lh" = (
/turf/open/floor/plating/is12/wwidirtplating,
/area/ctf/warfare)
"lO" = (
/obj/effect/turf_decal/is12,
/turf/open/floor/plating/is12/wood,
/area/ctf/warfare)
"lX" = (
/obj/item/flashlight/flare{
	pixel_x = -2;
	pixel_y = 3
	},
/turf/open/floor/plating/is12/trenchcenter,
/area/ctf/warfare)
"mS" = (
/obj/machinery/light/red/directional/north,
/obj/item/flashlight/flare,
/turf/open/floor/plating/is12/wood,
/area/ctf/warfare)
"na" = (
/obj/item/ctf/blue,
/turf/open/floor/plating/is12/wood,
/area/ctf/warfare)
"nn" = (
/obj/structure/deployable_barricade/sandbags,
/obj/item/binoculars,
/turf/open/floor/plating/is12/wwidirtplating,
/area/ctf/warfare)
"oE" = (
/obj/effect/turf_decal/is12,
/turf/open/floor/plating/is12/rock,
/area/ctf/warfare)
"oW" = (
/obj/machinery/light/red/directional/south,
/turf/open/floor/plating/is12/wood,
/area/ctf/warfare)
"sd" = (
/obj/structure/deployable_barricade/sandbags,
/obj/structure/deployable_barricade/sandbags{
	dir = 4
	},
/turf/open/floor/plating/is12/wwidirtplating,
/area/ctf/warfare)
"sp" = (
/obj/effect/turf_decal/is12{
	icon_state = "grass"
	},
/turf/open/floor/plating/is12/rock,
/area/ctf/warfare)
"sv" = (
/obj/structure/deployable_barricade/sandbags,
/obj/structure/deployable_barricade/sandbags{
	dir = 8
	},
/turf/open/floor/plating/is12/wwidirtplating,
/area/ctf/warfare)
"sM" = (
/obj/item/flashlight/flare,
/turf/open/floor/plating/is12/trenchcenter,
/area/ctf/warfare)
"sZ" = (
/obj/effect/turf_decal/is12{
	icon_state = "l4"
	},
/turf/open/floor/plating/is12/rock,
/area/ctf/warfare)
"tN" = (
/obj/item/reagent_containers/glass/bucket/wooden,
/turf/open/floor/plating/is12/wood,
/area/ctf/warfare)
"tO" = (
/obj/machinery/capture_the_flag/blue/warfare,
/turf/open/floor/plating/is12/wood,
/area/ctf/warfare)
"tQ" = (
/obj/structure/deployable_barricade/sandbags,
/turf/open/floor/plating/is12/rock,
/area/ctf/warfare)
"ut" = (
/obj/effect/turf_decal/is12{
	icon_state = "m1"
	},
/turf/open/floor/plating/is12/surface,
/area/ctf/warfare)
"uR" = (
/obj/structure/deployable_barricade/sandbags{
	dir = 8
	},
/turf/open/floor/plating/is12/rock,
/area/ctf/warfare)
"vj" = (
/obj/machinery/capture_the_flag/yellow/warfare,
/obj/effect/turf_decal/is12{
	icon_state = "dirtcornerleft"
	},
/turf/open/floor/plating/is12/wood,
/area/ctf/warfare)
"vp" = (
/obj/effect/turf_decal/is12{
	icon_state = "l6"
	},
/turf/open/floor/plating/is12/rock,
/area/ctf/warfare)
"wN" = (
/obj/effect/turf_decal/is12{
	icon_state = "m2"
	},
/turf/open/floor/plating/is12/surface,
/area/ctf/warfare)
"xn" = (
/obj/machinery/light/red/directional/north,
/turf/open/floor/plating/is12/wood,
/area/ctf/warfare)
"xE" = (
/obj/item/stack/cannonball/fourteen,
/turf/open/floor/plating/is12/wood,
/area/ctf/warfare)
"yp" = (
/turf/open/floor/plating/is12/surface,
/area/ctf/warfare)
"yQ" = (
/obj/effect/turf_decal/is12{
	icon_state = "grass"
	},
/turf/open/floor/plating/is12/wwidirtplating,
/area/ctf/warfare)
"zp" = (
/obj/machinery/light/no_nightlight/directional/north,
/turf/open/floor/plating/is12/rock,
/area/ctf/warfare)
"zq" = (
/obj/effect/turf_decal/is12{
	icon_state = "m1"
	},
/turf/open/floor/plating/is12/dirt,
/area/ctf/warfare)
"AN" = (
/obj/structure/trap/ctf/blue,
/turf/open/floor/plating/is12/trenchcenter,
/area/ctf/warfare)
"Bn" = (
/turf/open/floor/plating/is12/mud,
/area/ctf/warfare)
"CI" = (
/obj/effect/turf_decal/is12{
	icon_state = "l7"
	},
/turf/open/floor/plating/is12/rock,
/area/ctf/warfare)
"De" = (
/obj/structure/deployable_barricade/sandbags,
/turf/open/floor/plating/is12/wwidirt,
/area/ctf/warfare)
"Dm" = (
/obj/item/flashlight/flare,
/turf/open/floor/plating/is12/wwidirtplating,
/area/ctf/warfare)
"Eb" = (
/obj/structure/deployable_barricade/sandbags,
/obj/structure/cannon,
/turf/open/floor/plating/is12/wwidirt,
/area/ctf/warfare)
"El" = (
/obj/structure/deployable_barricade/sandbags{
	dir = 1
	},
/turf/open/floor/plating/is12/wwidirtplating,
/area/ctf/warfare)
"Ey" = (
/turf/open/floor/plating/is12/wood,
/area/ctf/warfare)
"HY" = (
/obj/structure/deployable_barricade/sandbags{
	dir = 4
	},
/turf/open/floor/plating/is12/dirt,
/area/ctf/warfare)
"IB" = (
/obj/effect/turf_decal/is12{
	icon_state = "dirtcornerright"
	},
/turf/open/floor/plating/is12/wood,
/area/ctf/warfare)
"IY" = (
/obj/structure/deployable_barricade/sandbags{
	dir = 1
	},
/obj/item/binoculars,
/turf/open/floor/plating/is12/wwidirtplating,
/area/ctf/warfare)
"Li" = (
/obj/effect/turf_decal/is12{
	icon_state = "l8"
	},
/turf/open/floor/plating/is12/rock,
/area/ctf/warfare)
"LH" = (
/turf/open/floor/plating/is12/rock,
/area/ctf/warfare)
"MB" = (
/obj/effect/turf_decal/is12{
	icon_state = "l5"
	},
/turf/open/floor/plating/is12/rock,
/area/ctf/warfare)
"MM" = (
/obj/effect/turf_decal/is12{
	icon_state = "l1"
	},
/turf/open/floor/plating/is12/rock,
/area/ctf/warfare)
"MT" = (
/obj/item/storage/box/firecrackers,
/turf/open/floor/plating/is12/wood,
/area/ctf/warfare)
"Nc" = (
/obj/structure/deployable_barricade/sandbags{
	dir = 1
	},
/obj/structure/deployable_barricade/sandbags{
	dir = 8
	},
/turf/open/floor/plating/is12/wwidirtplating,
/area/ctf/warfare)
"Ns" = (
/obj/structure/deployable_barricade/sandbags,
/obj/structure/deployable_barricade/sandbags{
	dir = 4
	},
/turf/open/floor/plating/is12/dirt,
/area/ctf/warfare)
"Of" = (
/turf/open/floor/plating/is12/dirt,
/area/ctf/warfare)
"Qb" = (
/obj/structure/deployable_barricade/sandbags{
	dir = 4
	},
/turf/open/floor/plating/is12/rock,
/area/ctf/warfare)
"Qc" = (
/obj/structure/deployable_barricade/sandbags{
	dir = 1
	},
/turf/open/floor/plating/is12/wwidirt,
/area/ctf/warfare)
"QX" = (
/obj/machinery/light/no_nightlight/directional/west,
/turf/open/floor/plating/is12/rock,
/area/ctf/warfare)
"Sw" = (
/obj/structure/deployable_barricade/sandbags{
	dir = 1
	},
/obj/structure/deployable_barricade/sandbags{
	dir = 4
	},
/turf/open/floor/plating/is12/wwidirtplating,
/area/ctf/warfare)
"TE" = (
/turf/closed/indestructible/riveted/dirtystone,
/area/ctf/warfare)
"TL" = (
/obj/effect/turf_decal/is12{
	icon_state = "grass"
	},
/turf/open/floor/plating/is12/dirt,
/area/ctf/warfare)
"Un" = (
/obj/structure/deployable_barricade/sandbags{
	dir = 1
	},
/obj/structure/deployable_barricade/sandbags{
	dir = 4
	},
/turf/open/floor/plating/is12/dirt,
/area/ctf/warfare)
"Uo" = (
/obj/item/ctf/yellow,
/turf/open/floor/plating/is12/wood,
/area/ctf/warfare)
"Uy" = (
/obj/effect/turf_decal/is12{
	icon_state = "m2"
	},
/turf/open/floor/plating/is12/dirt,
/area/ctf/warfare)
"Vj" = (
/obj/structure/trap/ctf/yellow,
/turf/open/floor/plating/is12/trenchcenter,
/area/ctf/warfare)
"VQ" = (
/obj/effect/turf_decal/is12{
	icon_state = "m3"
	},
/turf/open/floor/plating/is12/surface,
/area/ctf/warfare)
"VT" = (
/obj/structure/deployable_barricade/sandbags{
	dir = 8
	},
/turf/open/floor/plating/is12/trenchcenter,
/area/ctf/warfare)
"Wp" = (
/obj/item/flashlight/flare{
	pixel_x = -2;
	pixel_y = 3
	},
/turf/open/floor/plating/is12/dirt,
/area/ctf/warfare)
"WW" = (
/obj/machinery/light/no_nightlight/directional/east,
/turf/open/floor/plating/is12/rock,
/area/ctf/warfare)
"WY" = (
/obj/effect/turf_decal/is12{
	icon_state = "m4"
	},
/turf/open/floor/plating/is12/surface,
/area/ctf/warfare)
"Xa" = (
/obj/structure/deployable_barricade/sandbags,
/turf/open/floor/plating/is12/wwidirtplating,
/area/ctf/warfare)
"Xe" = (
/obj/machinery/light/no_nightlight/directional/south,
/turf/open/floor/plating/is12/rock,
/area/ctf/warfare)
"Ym" = (
/obj/effect/turf_decal/is12{
	icon_state = "l9"
	},
/turf/open/floor/plating/is12/rock,
/area/ctf/warfare)
"Zy" = (
/turf/open/floor/plating/is12/trenchcenter,
/area/ctf/warfare)
"ZH" = (
/obj/effect/turf_decal/is12{
	icon_state = "grass"
	},
/obj/structure/deployable_barricade/sandbags{
	dir = 1
	},
/obj/structure/deployable_barricade/sandbags{
	dir = 8
	},
/turf/open/floor/plating/is12/dirt,
/area/ctf/warfare)

(1,1,1) = {"
TE
TE
TE
TE
TE
TE
TE
TE
TE
TE
TE
TE
TE
TE
TE
TE
TE
TE
TE
TE
TE
TE
TE
TE
TE
TE
TE
TE
TE
TE
TE
TE
TE
TE
TE
TE
TE
TE
TE
TE
TE
TE
TE
TE
TE
TE
TE
TE
TE
TE
"}
(2,1,1) = {"
TE
tO
Ey
Ey
Ey
xE
TE
LH
tQ
LH
LH
LH
QX
LH
Of
Zy
Zy
Zy
Xa
Of
Of
Of
Of
Bn
Bn
Bn
Bn
Bn
Bn
Of
Of
Of
El
Zy
Zy
Zy
Of
LH
LH
fJ
LH
LH
LH
LH
LH
LH
LH
LH
LH
TE
"}
(3,1,1) = {"
TE
fy
Ey
Ey
im
Ey
TE
LH
tQ
LH
LH
LH
LH
LH
eN
Zy
Zy
Zy
Xa
TL
Of
Of
Of
Bn
Bn
Bn
Bn
Bn
Bn
Bn
Of
Of
El
Zy
Zy
Zy
Of
LH
LH
fJ
LH
be
LH
LH
LH
LH
LH
LH
LH
TE
"}
(4,1,1) = {"
TE
mS
Ey
tN
Ey
Ey
AN
LH
tQ
LH
LH
LH
LH
LH
Of
Zy
Zy
Zy
Xa
Of
Of
Wp
Bn
Bn
Bn
Bn
Bn
Bn
Bn
Bn
ae
jh
El
Zy
Zy
Zy
Of
LH
LH
fJ
LH
LH
LH
LH
LH
LH
LH
LH
LH
TE
"}
(5,1,1) = {"
TE
Ey
lO
Ey
Ey
xE
TE
LH
tQ
LH
LH
LH
LH
LH
Of
Zy
Zy
Zy
Xa
Of
Of
Of
Bn
Bn
Bn
Bn
Bn
Bn
Bn
Bn
Uy
zq
El
Zy
Zy
Zy
Of
LH
LH
TE
TE
TE
jV
TE
TE
TE
LH
LH
LH
TE
"}
(6,1,1) = {"
TE
xE
Ey
Ey
xE
MT
TE
LH
tQ
LH
LH
LH
LH
LH
Of
Zy
sM
Zy
Xa
Of
Of
Bn
Bn
Bn
Bn
Bn
Bn
Bn
Bn
Bn
Of
Of
El
lX
Zy
Zy
Of
LH
LH
TE
Ey
Ey
Ey
Ey
IB
TE
LH
sp
LH
TE
"}
(7,1,1) = {"
TE
TE
TE
AN
TE
TE
TE
LH
tQ
LH
LH
LH
LH
LH
Of
Zy
Zy
Zy
Xa
Of
Of
Bn
Bn
Bn
Bn
Bn
Bn
Bn
Bn
Bn
Of
Of
IY
Zy
Zy
Zy
Of
LH
LH
Qc
tN
im
Ey
Ey
Ey
TE
LH
LH
LH
TE
"}
(8,1,1) = {"
TE
LH
LH
LH
LH
LH
LH
LH
LH
LH
LH
LH
LH
LH
Of
Zy
Zy
Zy
Xa
Of
Of
Bn
Bn
Bn
Bn
Bn
Bn
Bn
Bn
Bn
Of
Of
El
Zy
Zy
Zy
Of
LH
LH
aP
Ey
Ey
Uo
Ey
oW
TE
LH
LH
LH
TE
"}
(9,1,1) = {"
TE
Qb
Qb
Qb
Qb
Qb
Qb
LH
LH
LH
LH
LH
LH
LH
Of
ko
ko
ko
sd
Of
Of
Bn
Bn
Bn
Bn
Bn
Bn
Bn
Bn
Bn
Of
eN
Sw
ko
ko
ko
Of
LH
LH
Qc
Ey
Ey
lO
Ey
Ey
TE
LH
LH
LH
TE
"}
(10,1,1) = {"
TE
LH
LH
LH
LH
LH
LH
LH
LH
LH
oE
LH
LH
LH
Of
Of
Of
Of
Of
Of
Of
Bn
Bn
Bn
Bn
Bn
Bn
Bn
Bn
Bn
Of
Of
Of
Of
Of
Of
Of
LH
LH
TE
Ey
Ey
Ey
Ey
Ey
TE
LH
LH
be
TE
"}
(11,1,1) = {"
TE
LH
LH
LH
LH
LH
LH
LH
sp
TE
LH
LH
LH
LH
Of
Of
eo
dz
Of
Of
Of
Bn
Bn
Bn
Bn
Bn
Bn
Bn
Bn
Bn
Of
Of
Of
ZH
eo
Of
Of
LH
LH
TE
TE
TE
jV
TE
TE
TE
LH
LH
LH
TE
"}
(12,1,1) = {"
TE
LH
LH
LH
LH
LH
LH
LH
LH
TE
zp
LH
LH
lh
lh
lh
lh
Xa
lh
lh
yp
yp
yp
yp
yp
yp
yp
yp
yp
lh
lh
lh
lh
El
lh
lh
lh
LH
LH
LH
LH
LH
LH
LH
LH
LH
LH
LH
LH
TE
"}
(13,1,1) = {"
TE
LH
LH
be
LH
LH
LH
LH
LH
TE
LH
LH
lh
lh
lh
lh
yQ
Xa
lh
yp
yp
yp
gQ
WY
VQ
yp
yp
yp
yp
yp
yp
yp
lh
El
lh
lh
lh
lh
lh
LH
TE
LH
LH
LH
LH
CI
Li
MM
LH
TE
"}
(14,1,1) = {"
TE
LH
LH
sp
LH
LH
LH
LH
LH
LH
LH
LH
LH
LH
lh
lh
lh
Xa
Dm
lh
lh
lh
yp
wN
ut
yp
yp
yp
yp
yp
yp
lh
lh
El
lh
lh
lh
lh
LH
Xe
TE
LH
LH
LH
LH
vp
Ym
fh
LH
TE
"}
(15,1,1) = {"
TE
LH
LH
LH
TE
TE
TE
jV
TE
TE
TE
LH
LH
LH
Of
Of
HY
Ns
Of
Of
Of
Bn
Bn
Bn
Bn
Bn
Bn
Bn
Bn
Bn
Of
Of
Of
Un
HY
Of
Of
LH
LH
LH
TE
LH
LH
LH
LH
MB
sZ
gR
LH
TE
"}
(16,1,1) = {"
TE
LH
LH
LH
TE
Ey
Ey
Ey
Ey
Ey
TE
LH
LH
LH
Of
Of
Of
Of
Of
Of
Of
Bn
Bn
Bn
Bn
Bn
Bn
Bn
Bn
Bn
Of
Of
Of
Of
Of
Of
Of
LH
LH
LH
LH
LH
LH
LH
LH
LH
LH
LH
LH
TE
"}
(17,1,1) = {"
TE
LH
LH
LH
TE
Ey
Ey
Ey
Ey
Ey
De
LH
sp
LH
Of
VT
VT
VT
sv
Of
Of
Bn
Bn
Bn
Bn
Bn
Bn
Bn
Bn
Bn
Of
Of
Nc
VT
VT
VT
Of
LH
LH
LH
sp
LH
LH
uR
uR
uR
uR
uR
uR
TE
"}
(18,1,1) = {"
TE
LH
LH
LH
TE
xn
Ey
na
Ey
Ey
Eb
LH
LH
LH
Of
Zy
Zy
Zy
Xa
Of
Of
Bn
Bn
Bn
Bn
Bn
Bn
Bn
Bn
Bn
Of
Of
El
Zy
Zy
Zy
Of
LH
LH
LH
LH
LH
LH
LH
LH
LH
LH
LH
LH
TE
"}
(19,1,1) = {"
TE
LH
LH
LH
TE
Ey
im
Ey
Ey
tN
De
LH
LH
LH
Of
Zy
Zy
Zy
nn
Of
Of
Bn
Bn
Bn
Bn
Bn
Bn
Bn
Bn
Bn
Of
Of
El
Zy
lX
Zy
Of
LH
LH
LH
LH
fJ
LH
TE
TE
TE
Vj
TE
TE
TE
"}
(20,1,1) = {"
TE
LH
LH
LH
TE
Ey
Ey
Ey
Ey
iQ
TE
LH
LH
LH
Of
Zy
sM
Zy
Xa
eN
Of
Bn
Bn
Bn
Bn
Bn
Bn
Bn
Bn
Bn
Of
TL
El
Zy
Zy
Zy
Of
LH
LH
be
LH
fJ
LH
TE
MT
xE
Ey
Ey
xE
TE
"}
(21,1,1) = {"
TE
LH
LH
LH
TE
TE
TE
jV
TE
TE
TE
LH
LH
LH
Of
Zy
Zy
Zy
Xa
Of
Of
Bn
Bn
Bn
Bn
Bn
Bn
Bn
Bn
Of
Of
Of
El
Zy
Zy
Zy
Of
LH
LH
LH
LH
fJ
LH
TE
xE
im
Ey
Ey
Ey
TE
"}
(22,1,1) = {"
TE
LH
LH
LH
LH
LH
LH
LH
LH
LH
tQ
LH
LH
LH
Of
Zy
Zy
Zy
Xa
Of
Of
Bn
Bn
Bn
Bn
Bn
Bn
Bn
Bn
Of
Of
Of
El
Zy
Zy
Zy
Of
LH
LH
LH
LH
fJ
LH
Vj
Ey
Ey
tN
Ey
oW
TE
"}
(23,1,1) = {"
TE
LH
LH
LH
LH
LH
LH
LH
LH
LH
tQ
LH
LH
LH
TL
Zy
Zy
Zy
Xa
Of
Of
Bn
Bn
Bn
Bn
Bn
Bn
Bn
Of
Wp
Of
Of
El
Zy
Zy
Zy
Of
LH
LH
LH
LH
fJ
LH
TE
Ey
Ey
Ey
Ey
fy
TE
"}
(24,1,1) = {"
TE
LH
LH
LH
LH
LH
LH
LH
LH
LH
tQ
LH
LH
LH
Of
Zy
Zy
Zy
Xa
Of
Of
Of
Bn
Bn
Bn
Bn
Bn
Bn
Of
Of
Of
Of
El
Zy
Zy
Zy
Of
LH
WW
LH
LH
fJ
LH
TE
xE
Ey
Ey
Ey
vj
TE
"}
(25,1,1) = {"
TE
TE
TE
TE
TE
TE
TE
TE
TE
TE
TE
TE
TE
TE
TE
TE
TE
TE
TE
TE
TE
TE
TE
TE
TE
TE
TE
TE
TE
TE
TE
TE
TE
TE
TE
TE
TE
TE
TE
TE
TE
TE
TE
TE
TE
TE
TE
TE
TE
TE
"}
