//MAP CONVERTED BY dmm2tgm.py THIS HEADER COMMENT PREVENTS RECONVERSION, DO NOT REMOVE
"a" = (
/turf/closed/indestructible/wood,
/area/ctf)
"d" = (
/obj/structure/bookcase/random/adult,
/turf/open/floor/plating/is12/wood,
/area/ctf)
"e" = (
/obj/machinery/arena_spawn/red,
/turf/open/floor/plating/is12/wood,
/area/ctf)
"f" = (
/obj/structure/closet/cabinet{
	anchored = 1
	},
/obj/effect/turf_decal/box,
/turf/open/floor/plating/is12/wood,
/area/ctf)
"x" = (
/obj/effect/turf_decal/box,
/obj/structure/closet/cabinet{
	anchored = 1
	},
/turf/open/floor/plating/is12/wood,
/area/ctf)
"y" = (
/turf/open/floor/plating/is12/wood,
/area/ctf)
"B" = (
/obj/structure/bookcase/random/adult,
/obj/machinery/door/poddoor{
	id = "arena_default";
	name = "FUCK THIS DOOR FUCK YOU LET ME IN FUCK FUCK"
	},
/turf/open/floor/plating/is12/wood,
/area/ctf)
"G" = (
/obj/machinery/door/poddoor{
	id = "arena_default";
	name = "FUCK THIS DOOR FUCK YOU LET ME IN FUCK FUCK"
	},
/turf/open/floor/plating/is12/wood,
/area/ctf)
"R" = (
/obj/machinery/arena_spawn/green,
/turf/open/floor/plating/is12/wood,
/area/ctf)

(1,1,1) = {"
a
a
a
a
a
a
a
a
a
a
a
a
a
a
a
a
a
a
a
a
"}
(2,1,1) = {"
a
d
d
d
d
d
d
d
d
d
d
d
d
d
d
d
d
d
B
a
"}
(3,1,1) = {"
a
y
y
y
y
y
y
y
y
y
y
y
y
y
y
y
y
G
e
a
"}
(4,1,1) = {"
a
y
y
y
y
y
y
y
y
y
y
y
y
y
y
y
y
y
G
a
"}
(5,1,1) = {"
a
y
d
d
d
x
d
d
d
x
x
d
d
d
x
d
d
d
y
a
"}
(6,1,1) = {"
a
y
y
y
y
y
y
y
y
y
y
y
y
y
y
y
y
y
y
a
"}
(7,1,1) = {"
a
y
y
y
y
y
y
y
y
y
y
y
y
y
y
y
y
y
y
a
"}
(8,1,1) = {"
a
y
d
d
d
x
d
d
d
x
x
d
d
d
x
d
d
d
y
a
"}
(9,1,1) = {"
a
y
y
y
y
y
y
y
y
y
y
y
y
y
y
y
y
y
y
a
"}
(10,1,1) = {"
a
y
f
x
x
x
x
x
x
x
x
x
x
x
x
x
x
x
y
a
"}
(11,1,1) = {"
a
y
f
x
x
x
x
x
x
x
x
x
x
x
x
x
x
x
y
a
"}
(12,1,1) = {"
a
y
y
y
y
y
y
y
y
y
y
y
y
y
y
y
y
y
y
a
"}
(13,1,1) = {"
a
y
d
d
d
x
d
d
d
x
x
d
d
d
x
d
d
d
y
a
"}
(14,1,1) = {"
a
y
y
y
y
y
y
y
y
y
y
y
y
y
y
y
y
y
y
a
"}
(15,1,1) = {"
a
y
y
y
y
y
y
y
y
y
y
y
y
y
y
y
y
y
y
a
"}
(16,1,1) = {"
a
y
d
d
d
x
d
d
d
x
x
d
d
d
x
d
d
d
y
a
"}
(17,1,1) = {"
a
G
y
y
y
y
y
y
y
y
y
y
y
y
y
y
y
y
y
a
"}
(18,1,1) = {"
a
R
G
y
y
y
y
y
y
y
y
y
y
y
y
y
y
y
y
a
"}
(19,1,1) = {"
a
B
d
d
d
d
d
d
d
d
d
d
d
d
d
d
d
d
d
a
"}
(20,1,1) = {"
a
a
a
a
a
a
a
a
a
a
a
a
a
a
a
a
a
a
a
a
"}
