//MAP CONVERTED BY dmm2tgm.py THIS HEADER COMMENT PREVENTS RECONVERSION, DO NOT REMOVE
"a" = (
/obj/effect/baseturf_helper/asteroid,
/turf/template_noop,
/area/ctf)
"c" = (
/obj/effect/mob_spawn/human/corpse/assistant/brainrot_infection,
/turf/open/indestructible/labfloor,
/area/ctf)
"d" = (
/turf/open/floor/plasteel/stairs,
/area/ctf)
"e" = (
/turf/open/floor/grass/gensgrass/dirty,
/area/ctf)
"f" = (
/turf/open/indestructible/labfloor,
/area/ctf)
"g" = (
/turf/closed/indestructible/fakeglass,
/area/ctf)
"h" = (
/turf/closed/indestructible/iron,
/area/ctf)
"j" = (
/obj/structure/flora/tree/jungle/small,
/turf/open/floor/grass,
/area/ctf)
"l" = (
/obj/structure/trash_pile,
/obj/structure/trash_pile,
/obj/structure/trash_pile,
/turf/open/floor/trot,
/area/ctf)
"o" = (
/turf/closed/indestructible/fakedoor,
/area/ctf)
"p" = (
/obj/machinery/arena_spawn/red,
/turf/open/floor/plasteel/stairs{
	dir = 4
	},
/area/ctf)
"q" = (
/obj/structure/trash_pile,
/obj/structure/trash_pile,
/obj/structure/trash_pile,
/obj/structure/trash_pile,
/turf/open/floor/trot,
/area/ctf)
"s" = (
/turf/closed/indestructible/riveted,
/area/ctf)
"t" = (
/turf/open/floor/plasteel/stairs{
	dir = 8
	},
/area/ctf)
"u" = (
/obj/structure/rack,
/obj/item/newspaper{
	pixel_x = 2;
	pixel_y = 2
	},
/obj/item/newspaper,
/obj/item/newspaper{
	pixel_x = -2;
	pixel_y = -2
	},
/turf/open/indestructible/labfloor,
/area/ctf)
"v" = (
/obj/machinery/arena_spawn/green,
/turf/open/floor/plasteel/stairs{
	dir = 4
	},
/area/ctf)
"w" = (
/obj/effect/turf_decal/stripes/corner,
/turf/open/floor/grass,
/area/ctf)
"y" = (
/obj/effect/turf_decal/stripes/corner{
	dir = 8
	},
/turf/open/floor/trot,
/area/ctf)
"z" = (
/obj/effect/turf_decal/stripes/corner,
/turf/open/floor/trot,
/area/ctf)
"A" = (
/obj/structure/trash_pile,
/obj/structure/trash_pile,
/turf/open/floor/grass,
/area/ctf)
"B" = (
/turf/closed/indestructible/cult,
/area/ctf)
"D" = (
/obj/effect/turf_decal/stripes/corner{
	dir = 8
	},
/turf/open/floor/grass,
/area/ctf)
"E" = (
/obj/structure/flora/tree/jungle,
/turf/open/floor/grass/gensgrass/dirty,
/area/ctf)
"J" = (
/obj/structure/trash_pile,
/turf/open/floor/trot,
/area/ctf)
"K" = (
/turf/open/floor/plasteel/stairs{
	dir = 1
	},
/area/ctf)
"L" = (
/obj/effect/turf_decal/stripes{
	dir = 8
	},
/turf/open/floor/trot,
/area/ctf)
"M" = (
/obj/effect/turf_decal/stripes/corner{
	dir = 4
	},
/turf/open/floor/grass,
/area/ctf)
"N" = (
/obj/effect/turf_decal/stripes/corner{
	dir = 1
	},
/turf/open/floor/trot,
/area/ctf)
"P" = (
/turf/open/floor/trot,
/area/ctf)
"Q" = (
/obj/structure/closet/crate/trashcart/filled{
	anchorable = 0;
	anchored = 1
	},
/obj/structure/trash_pile,
/obj/structure/trash_pile,
/turf/open/floor/trot,
/area/ctf)
"R" = (
/obj/structure/trash_pile,
/turf/open/floor/grass,
/area/ctf)
"S" = (
/obj/machinery/door/poddoor{
	id = "arena_default";
	name = "FUCK THIS DOOR FUCK YOU LET ME IN FUCK FUCK"
	},
/obj/effect/turf_decal/stripes/full,
/turf/open/floor/trot,
/area/ctf)
"T" = (
/obj/effect/turf_decal/stripes{
	dir = 4
	},
/turf/open/floor/trot,
/area/ctf)
"U" = (
/turf/open/floor/asphalt,
/area/ctf)
"V" = (
/turf/open/floor/grass,
/area/ctf)
"W" = (
/obj/effect/turf_decal/stripes/corner{
	dir = 4
	},
/turf/open/floor/trot,
/area/ctf)
"X" = (
/obj/effect/turf_decal/stripes/corner{
	dir = 1
	},
/turf/open/floor/grass,
/area/ctf)
"Y" = (
/turf/template_noop,
/area/ctf)
"Z" = (
/obj/structure/closet/crate/trashcart/filled{
	anchorable = 0;
	anchored = 1
	},
/turf/open/floor/trot,
/area/ctf)

(1,1,1) = {"
Y
h
h
h
h
h
h
h
h
h
h
h
h
h
h
h
h
h
h
Y
"}
(2,1,1) = {"
a
h
e
V
V
V
p
V
V
V
p
V
V
V
p
V
V
e
h
Y
"}
(3,1,1) = {"
Y
h
V
V
V
V
V
V
V
V
V
V
V
V
V
V
V
e
h
Y
"}
(4,1,1) = {"
Y
h
R
V
P
P
P
P
P
P
P
P
P
P
P
P
V
V
h
Y
"}
(5,1,1) = {"
Y
h
A
R
P
P
P
P
P
P
P
P
P
P
P
P
V
K
h
Y
"}
(6,1,1) = {"
Y
h
R
V
P
P
V
V
V
V
V
V
V
V
P
P
V
V
h
Y
"}
(7,1,1) = {"
Y
h
V
V
P
P
V
V
V
V
V
V
V
V
P
P
V
V
h
Y
"}
(8,1,1) = {"
Y
h
R
V
P
P
V
V
V
e
e
V
V
V
P
P
V
V
h
Y
"}
(9,1,1) = {"
Y
h
A
R
P
P
V
V
V
E
e
V
V
V
P
P
V
K
h
Y
"}
(10,1,1) = {"
Y
h
R
V
P
P
V
V
V
V
V
V
V
V
P
P
V
V
h
Y
"}
(11,1,1) = {"
Y
h
V
V
P
P
V
V
V
V
V
V
V
V
P
P
V
V
h
Y
"}
(12,1,1) = {"
Y
h
d
V
P
P
P
P
P
P
P
P
P
P
P
P
V
V
h
Y
"}
(13,1,1) = {"
Y
h
e
V
P
P
P
P
P
P
P
P
P
P
P
P
V
K
h
Y
"}
(14,1,1) = {"
Y
h
V
V
V
V
t
V
w
T
T
M
V
t
V
V
e
e
h
Y
"}
(15,1,1) = {"
h
h
h
h
h
h
h
h
h
S
S
h
h
h
h
h
h
h
h
h
"}
(16,1,1) = {"
B
P
P
P
P
P
P
P
y
L
L
N
P
P
P
P
P
P
P
B
"}
(17,1,1) = {"
B
P
P
P
P
P
P
P
P
P
P
P
P
P
P
P
P
P
P
B
"}
(18,1,1) = {"
B
P
P
s
s
o
s
s
P
P
P
P
P
V
V
V
V
P
P
B
"}
(19,1,1) = {"
B
P
P
s
f
c
u
s
P
P
P
P
P
V
V
j
V
P
P
B
"}
(20,1,1) = {"
B
P
P
s
s
g
s
s
P
P
P
P
P
V
V
V
V
P
P
B
"}
(21,1,1) = {"
B
P
P
P
P
P
P
P
P
P
P
P
P
P
P
P
P
P
P
B
"}
(22,1,1) = {"
B
U
U
U
U
U
U
U
U
U
U
U
U
U
U
U
U
U
U
B
"}
(23,1,1) = {"
B
U
U
U
U
U
U
U
U
U
U
U
U
U
U
U
U
U
U
B
"}
(24,1,1) = {"
B
U
U
U
U
U
U
U
U
U
U
U
U
U
U
U
U
U
U
B
"}
(25,1,1) = {"
B
U
U
U
U
U
U
U
U
U
U
U
U
U
U
U
U
U
U
B
"}
(26,1,1) = {"
B
U
U
U
U
U
U
U
U
U
U
U
U
U
U
U
U
U
U
B
"}
(27,1,1) = {"
B
U
U
U
U
U
U
U
U
U
U
U
U
U
U
U
U
U
U
B
"}
(28,1,1) = {"
B
P
P
P
P
P
P
P
P
P
P
P
P
P
P
P
J
J
P
B
"}
(29,1,1) = {"
B
P
P
V
V
V
V
P
P
P
P
P
P
Z
J
Q
Q
Q
J
B
"}
(30,1,1) = {"
B
P
P
V
V
j
V
P
P
P
P
P
P
P
P
l
l
q
J
B
"}
(31,1,1) = {"
B
P
P
V
V
V
V
P
P
P
P
P
P
P
Z
P
Q
Z
J
B
"}
(32,1,1) = {"
B
P
P
P
P
P
P
P
P
P
P
P
P
P
P
P
P
J
P
B
"}
(33,1,1) = {"
B
P
P
P
P
P
P
P
z
T
T
W
P
P
P
P
P
P
P
B
"}
(34,1,1) = {"
h
h
h
h
h
h
h
h
h
S
S
h
h
h
h
h
h
h
h
h
"}
(35,1,1) = {"
Y
h
V
V
V
V
t
V
D
L
L
X
V
t
V
V
e
e
h
Y
"}
(36,1,1) = {"
Y
h
V
V
P
P
P
P
P
P
P
P
P
P
P
P
V
K
h
Y
"}
(37,1,1) = {"
Y
h
d
V
P
P
P
P
P
P
P
P
P
P
P
P
V
V
h
Y
"}
(38,1,1) = {"
Y
h
V
V
P
P
V
V
V
V
V
V
V
V
P
P
V
V
h
Y
"}
(39,1,1) = {"
Y
h
V
V
P
P
V
V
V
V
V
V
V
V
P
P
V
V
h
Y
"}
(40,1,1) = {"
Y
h
d
V
P
P
V
V
V
E
e
V
V
V
P
P
V
K
h
Y
"}
(41,1,1) = {"
Y
h
V
V
P
P
V
V
V
e
e
V
V
V
P
P
V
V
h
Y
"}
(42,1,1) = {"
Y
h
V
V
P
P
V
V
V
V
V
V
V
V
P
P
V
V
h
Y
"}
(43,1,1) = {"
Y
h
V
V
P
P
V
V
V
V
V
V
V
V
P
P
V
V
h
Y
"}
(44,1,1) = {"
Y
h
d
V
P
P
P
P
P
P
P
P
P
P
P
P
V
K
h
Y
"}
(45,1,1) = {"
Y
h
V
V
P
P
P
P
P
P
P
P
P
P
P
P
V
V
h
Y
"}
(46,1,1) = {"
Y
h
V
V
V
V
V
V
V
V
V
V
V
V
V
V
V
e
h
Y
"}
(47,1,1) = {"
Y
h
e
V
V
V
v
V
V
V
v
V
V
V
v
V
V
e
h
Y
"}
(48,1,1) = {"
Y
h
h
h
h
h
h
h
h
h
h
h
h
h
h
h
h
h
h
Y
"}
