//MAP CONVERTED BY dmm2tgm.py THIS HEADER COMMENT PREVENTS RECONVERSION, DO NOT REMOVE
"a" = (
/turf/template_noop,
/area/ctf)
"d" = (
/obj/structure/closet/abductor,
/turf/open/floor/plasteel/catwalk_floor,
/area/ctf)
"i" = (
/obj/item/kirbyplants/photosynthetic{
	anchored = 1
	},
/turf/open/floor/plasteel/catwalk_floor,
/area/ctf)
"o" = (
/obj/effect/baseturf_helper/asteroid,
/turf/closed/indestructible/alien,
/area/ctf)
"q" = (
/obj/item/kirbyplants/photosynthetic{
	anchored = 1
	},
/turf/open/floor/plating/abductor,
/area/ctf)
"s" = (
/obj/structure/bed/abductor,
/obj/machinery/arena_spawn/green,
/turf/open/floor/plasteel/catwalk_floor,
/area/ctf)
"x" = (
/turf/closed/indestructible/alien,
/area/ctf)
"y" = (
/turf/open/floor/plasteel/catwalk_floor,
/area/ctf)
"F" = (
/obj/machinery/door/airlock/abductor,
/turf/open/floor/plasteel/catwalk_floor,
/area/ctf)
"G" = (
/obj/structure/bed/abductor,
/obj/machinery/arena_spawn/red,
/turf/open/floor/plasteel/catwalk_floor,
/area/ctf)
"O" = (
/turf/open/floor/plating/abductor,
/area/ctf)
"S" = (
/obj/machinery/door/poddoor{
	id = "arena_default";
	name = "FUCK THIS DOOR FUCK YOU LET ME IN FUCK FUCK"
	},
/turf/open/floor/plasteel/catwalk_floor,
/area/ctf)
"Z" = (
/obj/effect/spawner/structure/window/plasma/reinforced/plastitanium,
/turf/open/floor/plating/abductor,
/area/ctf)

(1,1,1) = {"
a
a
a
a
a
a
a
a
a
a
a
a
a
a
a
a
a
a
a
a
"}
(2,1,1) = {"
a
a
a
a
x
a
a
a
a
a
a
a
a
a
a
x
a
a
a
a
"}
(3,1,1) = {"
a
a
a
o
x
x
x
x
x
x
x
x
x
x
x
x
x
a
a
a
"}
(4,1,1) = {"
a
a
a
a
x
y
G
y
G
y
y
G
y
G
y
x
a
a
a
a
"}
(5,1,1) = {"
a
a
a
a
x
y
y
y
y
y
y
y
y
y
y
x
a
a
a
a
"}
(6,1,1) = {"
a
a
a
x
x
O
O
O
O
y
y
O
O
O
O
x
x
a
a
a
"}
(7,1,1) = {"
a
a
a
x
O
O
O
O
O
y
y
O
O
O
O
O
x
a
a
a
"}
(8,1,1) = {"
a
a
a
x
q
O
O
O
O
y
y
O
O
O
O
q
x
a
a
a
"}
(9,1,1) = {"
a
a
a
x
x
x
x
x
x
S
S
x
x
x
x
x
x
a
a
a
"}
(10,1,1) = {"
a
a
a
x
q
O
O
O
O
y
y
O
O
O
O
q
x
a
a
a
"}
(11,1,1) = {"
a
a
a
x
O
y
y
y
y
y
y
y
y
y
y
O
x
a
a
a
"}
(12,1,1) = {"
a
a
a
x
O
y
O
x
Z
Z
Z
Z
x
x
F
x
x
a
a
a
"}
(13,1,1) = {"
a
a
a
x
O
y
O
x
i
y
y
i
x
O
y
O
x
a
a
a
"}
(14,1,1) = {"
a
a
a
x
O
y
O
x
y
y
y
y
x
O
y
O
x
a
a
a
"}
(15,1,1) = {"
a
a
a
x
x
F
x
x
x
F
F
x
x
O
y
O
x
a
a
a
"}
(16,1,1) = {"
a
a
a
x
O
y
y
y
y
y
y
y
y
y
y
O
x
a
a
a
"}
(17,1,1) = {"
a
a
a
x
O
y
O
O
O
O
O
O
O
O
y
O
x
a
a
a
"}
(18,1,1) = {"
a
a
a
x
O
y
O
x
Z
Z
Z
Z
x
O
y
O
x
a
a
a
"}
(19,1,1) = {"
a
a
a
x
O
y
O
x
i
y
y
y
F
y
y
O
x
a
a
a
"}
(20,1,1) = {"
a
a
a
x
x
F
x
x
y
d
d
y
x
O
y
O
x
a
a
a
"}
(21,1,1) = {"
a
a
a
x
O
y
O
x
y
d
d
y
x
x
F
x
x
a
a
a
"}
(22,1,1) = {"
a
a
a
x
O
y
y
F
y
y
y
i
x
O
y
O
x
a
a
a
"}
(23,1,1) = {"
a
a
a
x
O
y
O
x
Z
Z
Z
Z
x
O
y
O
x
a
a
a
"}
(24,1,1) = {"
a
a
a
x
O
y
O
O
O
O
O
O
O
O
y
O
x
a
a
a
"}
(25,1,1) = {"
a
a
a
x
O
y
y
y
y
y
y
y
y
y
y
O
x
a
a
a
"}
(26,1,1) = {"
a
a
a
x
O
y
O
x
x
F
F
x
x
x
F
x
x
a
a
a
"}
(27,1,1) = {"
a
a
a
x
O
y
O
x
y
y
y
y
x
O
y
O
x
a
a
a
"}
(28,1,1) = {"
a
a
a
x
O
y
O
x
i
y
y
i
x
O
y
O
x
a
a
a
"}
(29,1,1) = {"
a
a
a
x
x
F
x
x
Z
Z
Z
Z
x
O
y
O
x
a
a
a
"}
(30,1,1) = {"
a
a
a
x
O
y
y
y
y
y
y
y
y
y
y
O
x
a
a
a
"}
(31,1,1) = {"
a
a
a
x
q
O
O
O
O
y
y
O
O
O
O
q
x
a
a
a
"}
(32,1,1) = {"
a
a
a
x
x
x
x
x
x
S
S
x
x
x
x
x
x
a
a
a
"}
(33,1,1) = {"
a
a
a
x
q
O
O
O
O
y
y
O
O
O
O
q
x
a
a
a
"}
(34,1,1) = {"
a
a
a
x
O
O
O
O
O
y
y
O
O
O
O
O
x
a
a
a
"}
(35,1,1) = {"
a
a
a
x
x
O
O
O
O
y
y
O
O
O
O
x
x
a
a
a
"}
(36,1,1) = {"
a
a
a
a
x
y
y
y
y
y
y
y
y
y
y
x
a
a
a
a
"}
(37,1,1) = {"
a
a
a
a
x
y
s
y
s
y
y
s
y
s
y
x
a
a
a
a
"}
(38,1,1) = {"
a
a
a
x
x
x
x
x
x
x
x
x
x
x
x
x
x
a
a
a
"}
(39,1,1) = {"
a
a
a
a
x
a
a
a
a
a
a
a
a
a
a
x
a
a
a
a
"}
(40,1,1) = {"
a
a
a
a
a
a
a
a
a
a
a
a
a
a
a
a
a
a
a
a
"}
