//MAP CONVERTED BY dmm2tgm.py THIS HEADER COMMENT PREVENTS RECONVERSION, DO NOT REMOVE
"ay" = (
/obj/machinery/atmospherics/components/unary/vent_pump/on/layer4{
	dir = 1
	},
/turf/open/floor/plasteel/dark,
/area/engineering/main)
"aP" = (
/obj/machinery/atmospherics/pipe/smart/manifold4w/supply/hidden/layer4{
	dir = 4
	},
/obj/structure/railing{
	dir = 1
	},
/obj/effect/turf_decal/stripes/line{
	dir = 1
	},
/obj/machinery/atmospherics/pipe/smart/manifold4w/scrubbers/hidden/layer2{
	dir = 1
	},
/obj/machinery/door/firedoor/border_only{
	dir = 1
	},
/turf/open/floor/plasteel/dark,
/area/engineering/main)
"bb" = (
/obj/machinery/atmospherics/components/unary/vent_scrubber/on/layer2{
	dir = 1
	},
/turf/open/floor/plasteel,
/area/engineering/main)
"bJ" = (
/obj/structure/lattice/catwalk,
/obj/machinery/atmospherics/pipe/heat_exchanging/junction{
	dir = 8
	},
/obj/machinery/meter,
/turf/template_noop,
/area/space/nearstation)
"bM" = (
/obj/effect/turf_decal/stripes/box,
/obj/structure/cable/multilayer/multiz,
/turf/open/floor/plasteel/dark,
/area/engineering/main)
"bX" = (
/obj/machinery/light/small{
	dir = 8
	},
/obj/structure/closet/emcloset/anchored,
/turf/open/floor/plating,
/area/engineering/main)
"bY" = (
/obj/structure/lattice/catwalk,
/obj/structure/railing{
	dir = 8
	},
/turf/open/openspace,
/area/engineering/main)
"ct" = (
/obj/machinery/atmospherics/pipe/smart/manifold4w/supply/hidden/layer4{
	dir = 4
	},
/obj/machinery/atmospherics/pipe/smart/manifold4w/scrubbers/hidden/layer2{
	dir = 4
	},
/obj/effect/turf_decal/stripes/end{
	dir = 4
	},
/obj/machinery/atmospherics/pipe/smart/manifold4w/orange/visible/layer1,
/obj/machinery/door/airlock/engineering/glass{
	name = "Engine Room";
	req_access_txt = "10"
	},
/obj/machinery/door/firedoor/border_only{
	dir = 8
	},
/obj/machinery/door/firedoor/border_only{
	dir = 4
	},
/turf/open/floor/plasteel/dark,
/area/engineering/main)
"cC" = (
/obj/effect/turf_decal/tile/yellow{
	dir = 4
	},
/obj/structure/cable,
/obj/machinery/atmospherics/pipe/layer_manifold/visible,
/obj/machinery/airalarm{
	dir = 8;
	pixel_x = 23
	},
/turf/open/floor/plasteel/dark,
/area/engineering/main)
"cJ" = (
/obj/structure/sign/warning/fire,
/turf/closed/wall/r_wall,
/area/engineering/main)
"di" = (
/obj/effect/turf_decal/stripes/corner{
	dir = 1
	},
/obj/structure/railing/corner{
	dir = 1
	},
/obj/machinery/atmospherics/pipe/smart/manifold4w/scrubbers/hidden/layer2{
	dir = 1
	},
/obj/machinery/door/firedoor/border_only{
	dir = 1
	},
/turf/open/floor/plasteel/dark,
/area/engineering/main)
"dy" = (
/obj/effect/spawner/structure/window/reinforced,
/turf/open/floor/plating,
/area/engineering/main)
"dL" = (
/obj/machinery/light{
	dir = 1;
	pixel_y = 0
	},
/obj/effect/turf_decal/stripes/line{
	dir = 4
	},
/obj/machinery/door/firedoor/border_only{
	dir = 4
	},
/turf/open/floor/plasteel/dark,
/area/engineering/main)
"dM" = (
/turf/open/openspace,
/area/engineering/main)
"et" = (
/obj/effect/turf_decal/stripes/line{
	dir = 4
	},
/turf/open/floor/plasteel/dark,
/area/engineering/main)
"eH" = (
/obj/structure/table,
/obj/item/stack/sheet/plasteel/twenty,
/turf/open/floor/plasteel/dark,
/area/engineering/main)
"fM" = (
/turf/template_noop,
/area/template_noop)
"gx" = (
/obj/structure/table,
/obj/item/stack/sheet/iron/fifty{
	pixel_x = -5;
	pixel_y = 2
	},
/turf/open/floor/plasteel/dark,
/area/engineering/main)
"gA" = (
/obj/machinery/atmospherics/pipe/multiz/violet,
/turf/open/floor/plasteel/dark,
/area/engineering/main)
"gO" = (
/obj/effect/turf_decal/tile/yellow{
	dir = 8
	},
/obj/machinery/firealarm{
	dir = 4;
	pixel_x = -24
	},
/turf/open/floor/plasteel/dark,
/area/engineering/main)
"gU" = (
/obj/machinery/atmospherics/pipe/smart/manifold4w/scrubbers/hidden/layer2{
	dir = 1
	},
/obj/effect/turf_decal/stripes/corner,
/turf/open/floor/plasteel/dark,
/area/engineering/main)
"hj" = (
/obj/effect/turf_decal/stripes/corner{
	dir = 1
	},
/obj/effect/turf_decal/tile/yellow,
/turf/open/floor/plasteel/dark,
/area/engineering/main)
"hq" = (
/obj/effect/turf_decal/tile/yellow{
	dir = 8
	},
/obj/machinery/light{
	pixel_y = 0
	},
/turf/open/floor/plasteel/dark,
/area/engineering/main)
"hB" = (
/obj/machinery/portable_atmospherics/canister/nitrogen,
/turf/open/floor/plasteel/dark,
/area/engineering/main)
"ii" = (
/obj/structure/lattice/catwalk,
/obj/structure/railing{
	dir = 4
	},
/turf/open/openspace,
/area/engineering/main)
"in" = (
/obj/machinery/atmospherics/pipe/smart/manifold4w/supply/hidden/layer4{
	dir = 4
	},
/obj/effect/turf_decal/stripes/corner{
	dir = 4
	},
/obj/structure/railing/corner{
	dir = 4
	},
/obj/machinery/atmospherics/pipe/smart/manifold4w/scrubbers/hidden/layer2{
	dir = 1
	},
/obj/effect/turf_decal/stripes/line,
/obj/machinery/door/firedoor/border_only{
	dir = 1
	},
/turf/open/floor/plasteel/dark,
/area/engineering/main)
"iK" = (
/obj/structure/lattice,
/obj/machinery/atmospherics/pipe/heat_exchanging/simple{
	dir = 6
	},
/turf/template_noop,
/area/space/nearstation)
"ja" = (
/obj/effect/turf_decal/tile/yellow{
	dir = 8
	},
/obj/effect/turf_decal/box/white,
/obj/machinery/space_heater,
/turf/open/floor/plasteel/dark,
/area/engineering/main)
"jd" = (
/obj/machinery/portable_atmospherics/canister/toxins,
/turf/open/floor/plasteel/dark,
/area/engineering/main)
"jh" = (
/obj/structure/lattice,
/turf/open/openspace,
/area/engineering/main)
"jC" = (
/obj/structure/lattice,
/obj/machinery/atmospherics/pipe/heat_exchanging/simple,
/obj/machinery/atmospherics/pipe/heat_exchanging/simple{
	dir = 4
	},
/obj/structure/lattice,
/turf/template_noop,
/area/space/nearstation)
"kb" = (
/obj/machinery/atmospherics/pipe/smart/manifold4w/violet/visible,
/turf/open/floor/plasteel/dark,
/area/engineering/main)
"kq" = (
/obj/machinery/atmospherics/components/binary/pump{
	dir = 1
	},
/turf/open/floor/plasteel/dark,
/area/engineering/main)
"lh" = (
/obj/structure/cable,
/obj/machinery/atmospherics/pipe/smart/manifold4w/supply/hidden/layer4,
/obj/machinery/atmospherics/pipe/smart/manifold4w/scrubbers/hidden/layer2,
/turf/open/floor/plasteel,
/area/engineering/main)
"lt" = (
/obj/machinery/atmospherics/pipe/smart/manifold4w/scrubbers/hidden/layer2{
	dir = 4
	},
/obj/effect/turf_decal/tile/yellow{
	dir = 8
	},
/turf/open/floor/plasteel/dark,
/area/engineering/main)
"lG" = (
/obj/machinery/atmospherics/pipe/heat_exchanging/simple{
	dir = 10
	},
/obj/structure/lattice/catwalk,
/turf/template_noop,
/area/space/nearstation)
"lS" = (
/turf/closed/wall/r_wall,
/area/engineering/main)
"me" = (
/obj/structure/lattice/catwalk,
/obj/machinery/atmospherics/pipe/heat_exchanging/simple{
	dir = 9
	},
/turf/template_noop,
/area/space/nearstation)
"mj" = (
/obj/machinery/portable_atmospherics/canister/carbon_dioxide,
/obj/effect/turf_decal/box/white,
/turf/open/floor/plasteel/dark,
/area/engineering/main)
"mo" = (
/obj/machinery/portable_atmospherics/scrubber,
/obj/effect/turf_decal/box/white,
/turf/open/floor/plasteel/dark,
/area/engineering/main)
"no" = (
/obj/structure/lattice,
/obj/machinery/atmospherics/pipe/heat_exchanging/simple{
	dir = 6
	},
/obj/machinery/atmospherics/pipe/heat_exchanging/simple{
	dir = 9
	},
/turf/template_noop,
/area/space/nearstation)
"ny" = (
/obj/structure/lattice,
/obj/machinery/atmospherics/pipe/heat_exchanging/simple,
/obj/machinery/atmospherics/pipe/heat_exchanging/simple{
	dir = 4
	},
/turf/template_noop,
/area/space/nearstation)
"nR" = (
/obj/structure/lattice,
/turf/template_noop,
/area/space/nearstation)
"oz" = (
/obj/effect/turf_decal/stripes/line{
	dir = 1
	},
/turf/open/floor/plasteel/dark,
/area/engineering/main)
"pB" = (
/obj/machinery/firealarm{
	pixel_y = 24
	},
/obj/machinery/atmospherics/components/unary/vent_pump/on/layer4,
/obj/machinery/door/firedoor/border_only{
	dir = 4
	},
/turf/open/floor/plasteel/dark,
/area/engineering/main)
"pN" = (
/obj/structure/table,
/obj/item/storage/toolbox/mechanical{
	pixel_y = 5
	},
/obj/item/flashlight{
	pixel_x = 1;
	pixel_y = 5
	},
/obj/item/flashlight{
	pixel_x = 1;
	pixel_y = 5
	},
/turf/open/floor/plasteel,
/area/engineering/main)
"ss" = (
/obj/structure/lattice,
/obj/machinery/atmospherics/pipe/heat_exchanging/simple,
/obj/machinery/atmospherics/pipe/heat_exchanging/simple{
	dir = 4
	},
/turf/open/floor/plating,
/area/space/nearstation)
"sI" = (
/obj/machinery/atmospherics/pipe/smart/manifold4w/supply/hidden/layer4,
/obj/machinery/atmospherics/pipe/smart/manifold4w/scrubbers/hidden/layer2{
	dir = 1
	},
/turf/open/floor/plasteel/dark,
/area/engineering/main)
"tA" = (
/obj/machinery/atmospherics/components/binary/pump,
/turf/open/floor/plasteel/dark,
/area/engineering/main)
"tD" = (
/obj/structure/lattice,
/obj/machinery/atmospherics/pipe/heat_exchanging/simple{
	dir = 5
	},
/obj/machinery/atmospherics/pipe/heat_exchanging/simple{
	dir = 10
	},
/turf/template_noop,
/area/space/nearstation)
"tX" = (
/obj/machinery/portable_atmospherics/pump,
/obj/effect/turf_decal/tile/yellow{
	dir = 8
	},
/obj/effect/turf_decal/box/white,
/turf/open/floor/plasteel/dark,
/area/engineering/main)
"uT" = (
/obj/effect/turf_decal/tile/yellow{
	dir = 8
	},
/obj/machinery/meter,
/obj/machinery/atmospherics/pipe/smart/manifold4w/violet/visible,
/turf/open/floor/plasteel/dark,
/area/engineering/main)
"vh" = (
/obj/structure/rack,
/obj/item/clothing/mask/gas{
	pixel_x = 3;
	pixel_y = 3
	},
/obj/item/clothing/mask/gas,
/obj/item/clothing/mask/gas{
	pixel_x = -3;
	pixel_y = -3
	},
/turf/open/floor/plasteel,
/area/engineering/main)
"vk" = (
/obj/machinery/atmospherics/pipe/heat_exchanging/simple{
	dir = 6
	},
/obj/structure/lattice,
/turf/template_noop,
/area/space/nearstation)
"vR" = (
/obj/structure/lattice/catwalk,
/obj/machinery/atmospherics/pipe/smart/manifold4w/violet/visible,
/obj/machinery/meter,
/turf/template_noop,
/area/space/nearstation)
"wF" = (
/obj/machinery/atmospherics/pipe/heat_exchanging/simple{
	dir = 6
	},
/obj/structure/lattice/catwalk,
/turf/template_noop,
/area/space/nearstation)
"wI" = (
/obj/structure/lattice/catwalk,
/obj/machinery/atmospherics/pipe/heat_exchanging/simple{
	dir = 6
	},
/turf/template_noop,
/area/space/nearstation)
"xv" = (
/obj/structure/sign/warning/vacuum/external{
	pixel_x = 32
	},
/turf/open/floor/plating,
/area/engineering/main)
"xX" = (
/obj/structure/railing/corner{
	dir = 4
	},
/obj/effect/turf_decal/stripes/line{
	dir = 1
	},
/obj/machinery/atmospherics/pipe/smart/manifold4w/scrubbers/hidden/layer2{
	dir = 1
	},
/obj/machinery/door/firedoor/border_only{
	dir = 1
	},
/turf/open/floor/plasteel/dark,
/area/engineering/main)
"yh" = (
/obj/structure/lattice,
/obj/machinery/atmospherics/pipe/heat_exchanging/simple{
	dir = 9
	},
/obj/machinery/atmospherics/pipe/heat_exchanging/simple{
	dir = 6
	},
/turf/template_noop,
/area/space/nearstation)
"za" = (
/obj/machinery/atmospherics/pipe/heat_exchanging/simple{
	dir = 5
	},
/obj/structure/lattice/catwalk,
/turf/template_noop,
/area/space/nearstation)
"zf" = (
/obj/machinery/atmospherics/pipe/smart/manifold4w/scrubbers/hidden/layer2{
	dir = 4
	},
/obj/effect/turf_decal/stripes/end{
	dir = 8
	},
/obj/machinery/door/airlock/engineering/glass{
	name = "Engine Room";
	req_access_txt = "10"
	},
/obj/machinery/door/firedoor/border_only{
	dir = 4
	},
/obj/machinery/door/firedoor/border_only{
	dir = 8
	},
/turf/open/floor/plasteel/dark,
/area/engineering/main)
"zm" = (
/obj/machinery/atmospherics/pipe/smart/manifold4w/scrubbers/hidden/layer2{
	dir = 1
	},
/obj/effect/turf_decal/stripes/line,
/turf/open/floor/plasteel/dark,
/area/engineering/main)
"zM" = (
/obj/structure/lattice/catwalk,
/obj/machinery/atmospherics/pipe/heat_exchanging/simple{
	dir = 10
	},
/turf/open/floor/plating,
/area/space/nearstation)
"zP" = (
/obj/machinery/atmospherics/pipe/smart/manifold4w/scrubbers/hidden/layer2{
	dir = 4
	},
/obj/machinery/atmospherics/pipe/smart/manifold4w/supply/hidden/layer4{
	dir = 4
	},
/obj/effect/turf_decal/tile/yellow{
	dir = 4
	},
/obj/structure/cable,
/obj/machinery/atmospherics/pipe/smart/manifold4w/orange/visible/layer1,
/turf/open/floor/plasteel/dark,
/area/engineering/main)
"Ab" = (
/obj/machinery/atmospherics/pipe/smart/manifold4w/orange/visible/layer1,
/turf/open/floor/plasteel,
/area/engineering/main)
"Aq" = (
/turf/closed/wall/r_wall,
/area/space/nearstation)
"At" = (
/obj/structure/lattice,
/obj/machinery/atmospherics/pipe/heat_exchanging/simple{
	dir = 6
	},
/turf/template_noop,
/area/space/nearstation)
"AB" = (
/obj/structure/cable,
/obj/machinery/door/airlock/engineering/glass{
	name = "Engine Room";
	req_access_txt = "10"
	},
/obj/machinery/door/firedoor/border_only{
	dir = 1
	},
/obj/machinery/door/firedoor/border_only,
/turf/open/floor/plasteel/dark,
/area/engineering/main)
"AK" = (
/turf/open/floor/plasteel,
/area/engineering/main)
"Bv" = (
/obj/structure/closet/radiation,
/turf/open/floor/plasteel,
/area/engineering/main)
"BX" = (
/obj/effect/turf_decal/stripes/line{
	dir = 8
	},
/turf/open/floor/plasteel/dark,
/area/engineering/main)
"Cl" = (
/obj/structure/closet/secure_closet/engineering_electrical,
/obj/effect/turf_decal/box/white,
/turf/open/floor/plasteel/dark,
/area/engineering/main)
"CR" = (
/obj/structure/railing{
	dir = 1
	},
/obj/effect/turf_decal/stripes/line{
	dir = 1
	},
/obj/machinery/atmospherics/pipe/smart/manifold4w/scrubbers/hidden/layer2{
	dir = 1
	},
/obj/machinery/door/firedoor/border_only{
	dir = 1
	},
/turf/open/floor/plasteel/dark,
/area/engineering/main)
"CW" = (
/obj/machinery/atmospherics/pipe/heat_exchanging/simple{
	dir = 10
	},
/obj/structure/lattice,
/turf/template_noop,
/area/space/nearstation)
"Dd" = (
/obj/effect/mapping_helpers/airlock/cyclelink_helper,
/obj/machinery/door/airlock/external{
	name = "Engineering External Access";
	req_access_txt = "10;13"
	},
/turf/open/floor/plating,
/area/engineering/main)
"Dk" = (
/obj/structure/cable,
/obj/machinery/atmospherics/pipe/smart/manifold4w/supply/hidden/layer4{
	dir = 1
	},
/obj/machinery/atmospherics/pipe/smart/manifold4w/scrubbers/hidden/layer2{
	dir = 1
	},
/obj/machinery/atmospherics/pipe/smart/manifold4w/orange/visible/layer1,
/turf/open/floor/plasteel,
/area/engineering/main)
"Dx" = (
/obj/structure/lattice,
/obj/machinery/atmospherics/pipe/heat_exchanging/simple,
/turf/template_noop,
/area/space/nearstation)
"DT" = (
/obj/machinery/atmospherics/pipe/bridge_pipe/violet{
	dir = 4
	},
/obj/machinery/atmospherics/pipe/bridge_pipe/violet,
/turf/open/floor/plasteel/dark,
/area/engineering/main)
"EH" = (
/obj/structure/cable,
/obj/machinery/atmospherics/pipe/smart/manifold4w/supply/hidden/layer4{
	dir = 4
	},
/obj/machinery/atmospherics/pipe/smart/manifold4w/scrubbers/hidden/layer2{
	dir = 8
	},
/turf/open/floor/plasteel,
/area/engineering/main)
"EI" = (
/obj/machinery/atmospherics/pipe/smart/manifold4w/supply/hidden/layer4{
	dir = 4
	},
/obj/structure/railing{
	dir = 1
	},
/obj/effect/turf_decal/stripes/line{
	dir = 1
	},
/obj/machinery/atmospherics/pipe/smart/manifold4w/scrubbers/hidden/layer2{
	dir = 1
	},
/obj/machinery/door/firedoor/border_only{
	dir = 1
	},
/obj/effect/turf_decal/stripes/corner{
	dir = 8
	},
/turf/open/floor/plasteel/dark,
/area/engineering/main)
"Fo" = (
/obj/effect/spawner/structure/window/plasma/reinforced,
/turf/open/floor/plating,
/area/engineering/main)
"Gi" = (
/obj/structure/table,
/obj/item/storage/toolbox/mechanical{
	pixel_x = -1;
	pixel_y = 4
	},
/turf/open/floor/plasteel/dark,
/area/engineering/main)
"Go" = (
/turf/open/floor/engine,
/area/engineering/main)
"GD" = (
/obj/effect/turf_decal/stripes/line{
	dir = 1
	},
/obj/machinery/light{
	pixel_y = 0
	},
/turf/open/floor/plasteel/dark,
/area/engineering/main)
"GQ" = (
/obj/structure/lattice,
/obj/machinery/atmospherics/pipe/heat_exchanging/simple{
	dir = 9
	},
/turf/template_noop,
/area/space/nearstation)
"Hh" = (
/obj/structure/lattice/catwalk,
/obj/machinery/atmospherics/pipe/heat_exchanging/simple,
/turf/template_noop,
/area/space/nearstation)
"Hn" = (
/obj/machinery/atmospherics/pipe/smart/manifold4w/supply/hidden/layer4{
	dir = 4
	},
/obj/machinery/atmospherics/pipe/smart/manifold4w/scrubbers/hidden/layer2{
	dir = 1
	},
/obj/effect/turf_decal/stripes/line,
/turf/open/floor/plasteel/dark,
/area/engineering/main)
"Ho" = (
/obj/machinery/door/firedoor/border_only{
	dir = 8
	},
/obj/machinery/airalarm{
	pixel_y = 23
	},
/turf/open/floor/plasteel/dark,
/area/engineering/main)
"Ht" = (
/obj/effect/turf_decal/tile/yellow{
	dir = 8
	},
/obj/machinery/atmospherics/pipe/smart/manifold4w/violet/visible,
/obj/machinery/meter,
/turf/open/floor/plasteel/dark,
/area/engineering/main)
"HD" = (
/obj/effect/turf_decal/tile/yellow{
	dir = 8
	},
/obj/machinery/light{
	dir = 8
	},
/turf/open/floor/plasteel/dark,
/area/engineering/main)
"HX" = (
/obj/effect/turf_decal/tile/yellow{
	dir = 4
	},
/obj/structure/cable,
/obj/machinery/atmospherics/pipe/smart/manifold4w/orange/visible/layer1,
/turf/open/floor/plasteel/dark,
/area/engineering/main)
"Ic" = (
/obj/effect/turf_decal/stripes/corner{
	dir = 4
	},
/obj/effect/turf_decal/tile/yellow{
	dir = 8
	},
/turf/open/floor/plasteel/dark,
/area/engineering/main)
"Ih" = (
/obj/structure/table,
/obj/item/pipe_dispenser{
	pixel_y = 6
	},
/obj/item/pipe_dispenser,
/obj/item/pipe_dispenser{
	pixel_y = -6
	},
/turf/open/floor/plasteel/dark,
/area/engineering/main)
"Ix" = (
/obj/structure/lattice/catwalk,
/turf/template_noop,
/area/space/nearstation)
"Jg" = (
/turf/open/floor/plasteel/dark,
/area/engineering/main)
"Jx" = (
/obj/structure/sign/warning/nosmoking,
/turf/closed/wall/r_wall,
/area/engineering/main)
"Kn" = (
/obj/structure/lattice/catwalk,
/obj/machinery/atmospherics/pipe/heat_exchanging/simple{
	dir = 4
	},
/turf/template_noop,
/area/space/nearstation)
"Kr" = (
/obj/machinery/atmospherics/components/binary/pump{
	dir = 4
	},
/turf/closed/wall/r_wall,
/area/engineering/main)
"Mz" = (
/obj/structure/lattice,
/obj/machinery/atmospherics/pipe/heat_exchanging/simple,
/obj/structure/lattice,
/turf/template_noop,
/area/space/nearstation)
"ML" = (
/obj/structure/table,
/obj/item/stack/sheet/iron/fifty{
	pixel_x = 2;
	pixel_y = 2
	},
/turf/open/floor/plasteel/dark,
/area/engineering/main)
"Ns" = (
/obj/structure/table,
/obj/item/storage/toolbox/mechanical{
	pixel_x = -2;
	pixel_y = 11
	},
/obj/item/storage/toolbox/mechanical{
	pixel_x = -2;
	pixel_y = -1
	},
/turf/open/floor/plasteel/dark,
/area/engineering/main)
"Oq" = (
/obj/machinery/atmospherics/pipe/heat_exchanging/simple{
	dir = 9
	},
/obj/structure/lattice/catwalk,
/turf/template_noop,
/area/space/nearstation)
"ON" = (
/obj/structure/table,
/obj/item/stack/sheet/glass/fifty,
/turf/open/floor/plasteel/dark,
/area/engineering/main)
"OY" = (
/obj/structure/lattice,
/obj/machinery/atmospherics/pipe/heat_exchanging/simple{
	dir = 10
	},
/turf/template_noop,
/area/space/nearstation)
"Px" = (
/obj/machinery/atmospherics/pipe/smart/manifold4w/orange/visible/layer1,
/obj/machinery/light,
/turf/open/floor/plasteel,
/area/engineering/main)
"PF" = (
/obj/structure/table,
/obj/item/clothing/gloves/color/yellow,
/obj/item/storage/toolbox/electrical{
	pixel_y = 5
	},
/turf/open/floor/plasteel,
/area/engineering/main)
"PG" = (
/obj/machinery/atmospherics/pipe/smart/manifold4w/supply/hidden/layer4{
	dir = 5
	},
/obj/machinery/atmospherics/pipe/smart/manifold4w/scrubbers/hidden/layer2{
	dir = 1
	},
/obj/effect/turf_decal/stripes/line,
/turf/open/floor/plasteel/dark,
/area/engineering/main)
"PL" = (
/obj/structure/lattice/catwalk,
/obj/machinery/atmospherics/pipe/heat_exchanging/simple{
	dir = 10
	},
/turf/template_noop,
/area/space/nearstation)
"Sc" = (
/obj/structure/cable,
/turf/open/floor/plasteel/dark,
/area/engineering/main)
"SC" = (
/obj/machinery/atmospherics/components/binary/pump{
	dir = 8
	},
/turf/closed/wall/r_wall,
/area/engineering/main)
"Tt" = (
/obj/machinery/portable_atmospherics/canister/oxygen,
/turf/open/floor/plasteel/dark,
/area/engineering/main)
"Uu" = (
/obj/machinery/atmospherics/components/unary/vent_scrubber/on/layer2{
	dir = 1
	},
/turf/open/floor/plasteel/dark,
/area/engineering/main)
"Uz" = (
/obj/structure/lattice,
/obj/machinery/atmospherics/pipe/heat_exchanging/simple{
	dir = 4
	},
/turf/template_noop,
/area/space/nearstation)
"UK" = (
/obj/effect/turf_decal/tile/yellow{
	dir = 8
	},
/turf/open/floor/plasteel/dark,
/area/engineering/main)
"Vo" = (
/obj/machinery/atmospherics/pipe/smart/manifold4w/supply/hidden/layer4{
	dir = 4
	},
/obj/structure/railing/corner{
	dir = 1
	},
/obj/effect/turf_decal/stripes/line{
	dir = 1
	},
/obj/machinery/atmospherics/pipe/smart/manifold4w/scrubbers/hidden/layer2{
	dir = 1
	},
/obj/machinery/door/firedoor/border_only{
	dir = 1
	},
/turf/open/floor/plasteel/dark,
/area/engineering/main)
"VD" = (
/turf/closed/wall,
/area/engineering/main)
"Wb" = (
/obj/machinery/atmospherics/pipe/smart/manifold4w/scrubbers/hidden/layer2,
/obj/machinery/atmospherics/pipe/smart/manifold4w/supply/hidden/layer4,
/obj/machinery/door/airlock/engineering/glass{
	name = "Engine Room";
	req_access_txt = "10"
	},
/obj/machinery/door/firedoor/border_only,
/obj/machinery/door/firedoor/border_only{
	dir = 1
	},
/turf/open/floor/plasteel/dark,
/area/engineering/main)
"Wg" = (
/obj/structure/lattice/catwalk,
/obj/machinery/atmospherics/pipe/heat_exchanging/junction{
	dir = 1
	},
/turf/template_noop,
/area/space/nearstation)
"Wk" = (
/obj/structure/cable,
/obj/machinery/atmospherics/pipe/smart/manifold4w/supply/hidden/layer4,
/obj/machinery/atmospherics/pipe/smart/manifold4w/scrubbers/hidden/layer2,
/obj/machinery/atmospherics/pipe/smart/manifold4w/orange/visible/layer1,
/turf/open/floor/plasteel,
/area/engineering/main)
"Wp" = (
/obj/structure/lattice,
/obj/structure/grille,
/turf/template_noop,
/area/space/nearstation)
"Xs" = (
/obj/machinery/atmospherics/pipe/smart/manifold4w/scrubbers/hidden/layer2{
	dir = 5
	},
/turf/open/floor/plasteel,
/area/engineering/main)
"XD" = (
/obj/structure/table,
/obj/item/holosign_creator/atmos{
	pixel_x = -1;
	pixel_y = -14
	},
/obj/item/stack/sheet/glass/fifty{
	pixel_x = 3;
	pixel_y = 3
	},
/turf/open/floor/plasteel/dark,
/area/engineering/main)
"XV" = (
/obj/structure/lattice/catwalk,
/obj/machinery/atmospherics/pipe/heat_exchanging/simple{
	dir = 5
	},
/turf/template_noop,
/area/space/nearstation)
"Yb" = (
/obj/structure/lattice/catwalk,
/obj/machinery/atmospherics/pipe/heat_exchanging/simple{
	dir = 6
	},
/turf/open/floor/plating,
/area/space/nearstation)
"Yx" = (
/obj/structure/lattice,
/obj/machinery/atmospherics/pipe/heat_exchanging/simple,
/turf/template_noop,
/area/space/nearstation)
"YG" = (
/obj/effect/turf_decal/tile/yellow,
/turf/open/floor/plasteel/dark,
/area/engineering/main)
"YO" = (
/obj/effect/turf_decal/tile/yellow{
	dir = 4
	},
/obj/machinery/light{
	dir = 4
	},
/obj/machinery/atmospherics/pipe/multiz/orange{
	dir = 1
	},
/turf/open/floor/plasteel/dark,
/area/engineering/main)
"YU" = (
/obj/effect/mapping_helpers/airlock/cyclelink_helper{
	dir = 1
	},
/obj/machinery/door/airlock/external{
	name = "Engineering External Access";
	req_access_txt = "10;13"
	},
/obj/structure/fans/tiny,
/turf/open/floor/plating,
/area/engineering/main)
"YZ" = (
/obj/machinery/light{
	dir = 1;
	pixel_y = 0
	},
/obj/effect/turf_decal/stripes/line{
	dir = 8
	},
/obj/machinery/door/firedoor/border_only{
	dir = 8
	},
/turf/open/floor/plasteel/dark,
/area/engineering/main)
"Zl" = (
/obj/structure/lattice/catwalk,
/obj/machinery/atmospherics/pipe/heat_exchanging/simple{
	dir = 6
	},
/obj/machinery/atmospherics/pipe/heat_exchanging/simple{
	dir = 9
	},
/turf/template_noop,
/area/space/nearstation)

(1,1,1) = {"
fM
fM
fM
fM
fM
fM
fM
fM
fM
fM
fM
fM
fM
fM
fM
fM
fM
fM
fM
fM
fM
fM
Wp
Aq
Wp
fM
"}
(2,1,1) = {"
fM
fM
fM
fM
fM
fM
fM
dy
dy
wI
Hh
za
wF
za
wF
za
wF
XV
wF
za
Ix
Ix
Wp
Wp
Wp
fM
"}
(3,1,1) = {"
fM
fM
fM
fM
fM
fM
fM
dy
wI
no
Dx
jC
jC
jC
jC
ny
ny
jC
ny
ny
Dx
za
Wp
Aq
Wp
fM
"}
(4,1,1) = {"
fM
fM
fM
fM
fM
fM
fM
wI
GQ
OY
Yx
jC
jC
jC
jC
ny
ny
jC
ny
ny
Dx
Oq
nR
Aq
Wp
fM
"}
(5,1,1) = {"
fM
fM
fM
fM
fM
fM
fM
Kn
At
Mz
Mz
jC
jC
jC
jC
ny
ny
jC
ny
ny
Dx
za
Wp
Aq
Wp
fM
"}
(6,1,1) = {"
fM
fM
fM
fM
fM
fM
fM
Kn
Uz
vk
Mz
jC
jC
jC
jC
ny
ny
jC
ny
ny
Dx
Oq
Wp
Wp
Wp
fM
"}
(7,1,1) = {"
fM
fM
fM
fM
fM
fM
fM
Kn
OY
tD
Mz
jC
jC
jC
jC
ny
ny
jC
ny
ny
Dx
za
Wp
Aq
Wp
fM
"}
(8,1,1) = {"
fM
fM
fM
fM
fM
fM
fM
Kn
iK
yh
Mz
jC
jC
jC
jC
ny
ny
ny
ny
ny
Dx
Oq
Wp
Aq
Wp
fM
"}
(9,1,1) = {"
fM
fM
fM
fM
fM
fM
fM
Kn
OY
tD
Mz
jC
jC
jC
jC
ny
ny
ny
ny
ny
Dx
za
Wp
Aq
Wp
fM
"}
(10,1,1) = {"
fM
fM
fM
fM
VD
VD
lS
Kn
iK
yh
Mz
jC
jC
jC
jC
ny
ny
ny
ny
ny
Dx
Oq
nR
Wp
nR
fM
"}
(11,1,1) = {"
fM
fM
PF
pN
VD
bX
lS
Kn
Uz
CW
Mz
jC
jC
jC
jC
ny
ny
ny
ny
ny
Dx
za
Wp
Aq
Wp
fM
"}
(12,1,1) = {"
fM
fM
Xs
AK
Dd
xv
YU
bJ
PL
Wg
vR
lG
Oq
lG
Zl
ny
ny
ny
ny
ny
Dx
Oq
Wp
Wp
nR
fM
"}
(13,1,1) = {"
fM
Fo
zf
Fo
lS
lS
lS
SC
Fo
Fo
Kr
Fo
Fo
lS
zM
ss
ss
ss
ss
ss
Dx
za
nR
Aq
Wp
fM
"}
(14,1,1) = {"
Fo
Fo
lt
UK
gO
HD
UK
uT
UK
UK
Ht
tX
ja
lS
Yb
ss
ss
ss
ss
ss
Dx
Oq
nR
Wp
nR
fM
"}
(15,1,1) = {"
lS
ii
xX
Jg
Jg
gA
kq
DT
kb
kb
kb
Jg
hq
lS
zM
ss
ss
ss
ss
ss
Dx
za
Wp
Aq
Wp
fM
"}
(16,1,1) = {"
Fo
jh
CR
Uu
Jg
Jg
Jg
kb
Jg
Jg
Jg
Jg
UK
lS
Yb
ss
ss
ss
ss
ss
Dx
Oq
Wp
Aq
Wp
fM
"}
(17,1,1) = {"
Fo
dM
CR
Jg
Jg
gA
tA
kb
Jg
Jg
Jg
Jg
UK
Fo
zM
ss
ss
ss
ss
ss
Dx
za
nR
Aq
Wp
fM
"}
(18,1,1) = {"
cJ
YZ
di
Jg
Jg
Jg
Jg
Jg
Jg
Jg
Jg
Jg
UK
Fo
Yb
ss
ss
ss
ss
ss
Dx
Oq
Wp
Wp
Wp
fM
"}
(19,1,1) = {"
lS
Ho
gU
et
et
et
et
et
et
et
et
et
Ic
lS
zM
ss
ss
ss
ss
ss
Dx
za
nR
Aq
Wp
fM
"}
(20,1,1) = {"
AB
Sc
zm
Go
Go
Go
Go
Go
Go
Go
Go
Go
GD
lS
Yb
ss
ss
ss
ss
ss
Dx
Oq
Wp
Aq
Wp
fM
"}
(21,1,1) = {"
Fo
bM
zm
Go
Go
Go
Go
Go
Go
Go
Go
Go
oz
Fo
zM
ss
ss
ss
ss
ss
Dx
za
Wp
Aq
Wp
fM
"}
(22,1,1) = {"
Wb
sI
PG
Go
Go
Go
Go
Go
Go
Go
Go
Go
oz
Fo
Yb
ss
ss
ss
ss
ss
Dx
Oq
Wp
Wp
Wp
fM
"}
(23,1,1) = {"
lS
pB
Hn
Go
Go
Go
Go
Go
Go
Go
Go
Go
oz
Fo
zM
ss
ss
ss
ss
ss
Dx
za
Wp
Aq
Wp
fM
"}
(24,1,1) = {"
Jx
dL
in
Go
Go
Go
Go
Go
Go
Go
Go
Go
GD
lS
Yb
ss
ss
ss
ss
ss
Dx
Oq
Wp
Aq
nR
fM
"}
(25,1,1) = {"
Fo
dM
EI
BX
BX
BX
BX
BX
BX
BX
BX
BX
hj
lS
zM
ss
ss
ss
ss
ss
Dx
za
nR
Aq
Wp
fM
"}
(26,1,1) = {"
Fo
jh
aP
ay
Jg
Jg
Jg
Tt
jd
Cl
Cl
mo
YG
Fo
Yb
ss
ss
ss
ss
ss
Dx
Oq
Wp
Wp
Wp
fM
"}
(27,1,1) = {"
lS
bY
Vo
Jg
Jg
Jg
Jg
Jg
hB
Ns
ML
mo
YG
Fo
zM
ss
ss
ss
ss
ss
Dx
za
Wp
Aq
Wp
fM
"}
(28,1,1) = {"
Fo
Fo
zP
HX
cC
YO
Jg
Jg
Jg
Jg
Jg
Jg
YG
lS
Yb
ss
ss
ss
ss
ss
Dx
Oq
Wp
Aq
Wp
fM
"}
(29,1,1) = {"
Bv
Fo
ct
Fo
lS
lS
Jg
Jg
mj
ON
Ih
Gi
YG
lS
zM
ny
ny
ny
ny
ny
Dx
za
Wp
Aq
Wp
fM
"}
(30,1,1) = {"
fM
lh
Wk
bb
vh
Fo
Jg
Jg
mj
XD
eH
gx
YG
lS
Yb
ny
ny
ny
ny
ny
Dx
Oq
Wp
nR
nR
fM
"}
(31,1,1) = {"
fM
AK
Dk
Ab
Ab
Fo
YG
YG
YG
YG
YG
YG
YG
lS
PL
ny
ny
ny
ny
ny
Dx
XV
nR
Aq
Wp
fM
"}
(32,1,1) = {"
fM
AK
EH
AK
Px
lS
lS
lS
lS
lS
lS
lS
lS
lS
Ix
lG
Oq
lG
Oq
lG
Hh
me
Wp
Aq
Wp
fM
"}
