"a" = (/obj/effect/turf_decal/stripes/line{dir = 10},/obj/effect/landmark/stationroom/maintenance,/turf/open/openspace/airless,/area/space)
"m" = (/obj/effect/turf_decal/stripes/line{dir = 9},/turf/open/openspace/airless,/area/space)
"n" = (/turf/open/openspace/airless,/area/space)
"J" = (/obj/effect/turf_decal/stripes/line{dir = 5},/turf/open/openspace/airless,/area/space)
"T" = (/obj/effect/turf_decal/stripes/line{dir = 6},/turf/open/openspace/airless,/area/space)

(1,1,1) = {"
mnnnnnnnnJ
nnnnnnnnnn
nnnnnnnnnn
nnnnnnnnnn
nnnnnnnnnn
nnnnnnnnnn
nnnnnnnnnn
nnnnnnnnnn
nnnnnnnnnn
annnnnnnnT
"}
